kode_rs,nama_rs,total_tt,lk_terpakai,pr_terpakai,terpakai,lk_kosong,pr_kosong,kosong,wait_list,tgl_update
1101015,RS Umum Daerah Simeulue,790,235,274,509,28,46,281,426,04/Jul/2017 14:48:09
1102016,RS Umum Daerah Aceh Singkil,105,10,15,25,34,46,80,0,17/Apr/2020 06:37:24
1103010,RS Umum Daerah Dr. H. Yulidin Away,9,0,0,0,0,0,9,0,24/Feb/2018 09:56:22
1104011,RS Umum Daerah H. Sahudin Kutacane,155,71,80,151,71,80,4,0,16/Apr/2020 10:31:42
1173012,RS Umum Daerah Langsa,489,144,190,334,10,9,155,87,02/Jul/2018 08:07:45
1105034,RS Umum Pertamina Rantau,50,7,8,15,18,17,35,0,26/Feb/2019 10:22:18
1173045,RS Cut Nyak Dhien Langsa,79,17,30,47,25,5,32,0,05/Apr/2018 11:57:34
1105056,RS Umum Daerah dr. Zubir Mahmud,161,28,27,55,42,63,106,0,17/Apr/2020 06:42:49
1106013,RS Umum Daerah Datu Beru Takengon,289,43,32,75,58,86,214,0,03/Sep/2018 09:52:41
1107014,RS Umum Daerah Cut Nyak Dhien,235,75,88,163,35,28,72,0,26/Feb/2019 06:10:22
1108015,RS Umum Daerah Kabupaten Aceh Besar,106,0,0,0,56,50,106,0,08/Feb/2019 07:09:07
1109016,RS Umum Daerah TGK Chik Ditiro Sigli,345,129,124,253,177,168,92,0,14/Apr/2020 09:03:43
1109027,RS Umum Daerah TGK. Abdullah Syafii Beureuneun,145,64,61,125,64,61,20,0,06/Mar/2019 06:59:26
1174016,RS Umum Daerah Cut Meutia Kab. Aceh Utara,312,84,74,158,72,81,154,0,08/Jun/2018 11:32:53
1110027,RS Umum Malahayati,57,22,21,43,6,8,14,0,19/Feb/2019 06:27:54
1110053,RS Arun Lhokseumawe,10,0,5,5,0,5,5,0,27/Feb/2018 07:55:04
1110075,RS Umum Daerah Dr. Fauziah Bireun,619,180,207,387,92,107,232,0,01/Mar/2019 12:06:28
1110086,RS Umum Bunda,52,0,0,0,14,52,52,0,27/Feb/2018 10:12:01
1174100,RS Tk. IV Lhokseumawe Aceh Utara,128,32,22,54,0,0,74,0,19/Apr/2020 02:53:57
1112011,RS Umum Daerah Teungku Peukan,217,84,76,160,19,38,57,0,01/Mar/2019 11:41:29
1113012,RS Umum Muhammad Ali Kasim,97,32,26,58,0,0,39,0,08/Mar/2019 05:36:11
1114011,RS Umum Daerah Tamiang,438,201,242,443,115,115,-5,0,14/Sep/2017 10:50:16
1115012,RS Umum Daerah Sultan Iskandar Muda Nagan Raya,131,20,30,50,35,46,81,0,14/Apr/2020 06:29:49
1117025,RS Umum Daerah Muyang Kute Redelong Bener Meriah,163,19,40,59,50,54,104,0,04/Mar/2019 08:40:37
1171015,RS Umum Daerah  Dr. Zainoel Abidin,586,131,87,218,0,0,368,0,17/Apr/2020 15:31:55
1171026,RS Tk. II Iskandar Muda Banda Aceh,137,27,25,52,43,42,85,0,17/Apr/2020 10:33:14
1171041,RS Jiwa Aceh,354,268,53,321,37,12,33,0,02/Feb/2018 06:25:16
1171096,RS Umum Harapan Bunda Banda Aceh,142,0,0,0,0,0,142,0,27/Feb/2018 07:57:00
1171110,RS Umum Daerah Meuraxa,232,63,72,135,49,52,97,0,08/Mar/2019 01:24:24
1171121,RS Ibu dan Anak Propinsi NAD,140,19,54,73,0,15,67,0,06/Mar/2019 05:59:33
1172016,RS Umum Daerah Sabang,54,9,6,15,0,0,39,0,12/Mar/2018 08:30:26
1172031,RS AL Sabang,34,3,4,7,12,8,27,0,27/Feb/2018 07:41:55
1111018,RS Umum PMI Cabang Aceh Utara,49,0,0,0,0,0,49,0,05/Apr/2020 19:54:26
1202017,RS Umum Daerah dr. Husni Thamrin,12,2,3,5,4,3,7,0,19/Feb/2018 02:03:02
1277011,RS Umum Daerah Padang Sidempuan,194,9,3,12,0,0,182,0,19/Apr/2020 02:32:13
1203022,RS Umum Daerah Panyabungan,110,47,41,88,10,12,22,0,01/Mar/2019 07:09:34
1203033,RS Umum Daerah Tapanuli Selatan,80,0,0,0,0,0,80,0,02/Mar/2019 11:07:27
1203044,RS Umum Daerah Gunung Tua,100,8,8,16,32,52,84,0,17/Apr/2020 06:08:04
1203055,RS Umum Daerah Sibuhuan,91,22,16,38,24,24,53,0,11/Apr/2020 06:41:18
1204056,RS Umum Daerah Pandan,100,11,36,47,0,0,53,0,19/Feb/2018 10:22:25
1205013,RS Umum Daerah Tarutung,240,47,41,88,76,78,152,0,05/Feb/2018 01:38:00
1205024,RS Umum Daerah Dr. Hadrianus Sinaga,80,13,27,40,0,0,40,0,06/Mar/2018 01:17:05
1205035,RS Umum Daerah Dolok Sanggul,118,10,17,27,33,58,91,0,16/Apr/2020 04:28:27
1205046,RS Umum Daerah Porsea,84,0,0,0,0,0,84,0,06/Mar/2018 01:06:29
1207015,RS Umum Daerah Rantau Prapat,183,33,38,71,38,64,112,0,15/Apr/2020 03:34:48
1208016,RS Umum Daerah H. Abdul Manan Simatupang,27,11,12,23,0,5,4,0,03/Aug/2018 10:11:25
1208053,RS Umum Sei Dadap,41,1,4,5,20,16,36,0,11/Apr/2020 06:09:45
1209054,RS GKPS Bethesda Saribu Dolok,35,0,0,0,35,0,35,0,19/Apr/2020 22:30:53
1209076,RS Umum Daerah Perdagangan,43,17,16,33,21,18,10,0,26/Feb/2019 05:48:13
1210010,RS Umum Daerah Sidikalang,120,26,33,59,30,31,61,0,06/Mar/2018 01:09:16
1211011,RS Umum Daerah Kabanjahe,203,70,63,133,41,45,70,0,08/Mar/2019 03:25:53
1211033,RS Umum Kusta Lau Simomo,42,6,7,13,0,0,29,0,27/Dec/2018 08:00:39
1212012,RS Umum Dearah Deli Serdang,277,95,101,196,0,0,81,0,26/Feb/2018 06:54:03
1218125,RS Umum Daerah Sultan Sulaiman Syariful Alamsyah,127,51,11,62,38,28,65,0,17/Apr/2020 07:34:20
1213013,RS Umum Daerah Tanjung Pura,27,0,24,24,3,4,3,0,27/Feb/2018 09:59:39
1213024,RS Umum PTP II Tg Selamat,103,4,7,11,57,35,92,0,06/Apr/2020 07:04:04
1214010,RS Umum Daerah Lukas Hilisimaetano,68,4,3,7,11,27,61,0,06/Mar/2018 01:00:21
1216011,RS Umum Daerah Salak,76,7,2,9,31,38,67,0,17/Apr/2020 01:14:28
1271016,RS Umum Daerah Dr. Fl Tobing Sibolga,162,25,18,43,81,94,119,0,01/Mar/2019 06:22:34
1272010,RS Umum Daerah Dr. Tengku Mansyur,141,27,46,73,29,39,68,0,02/Apr/2020 06:17:48
1273011,RS Umum Daerah Dr. Djasamen Saragih,162,5,2,7,61,88,155,0,18/Apr/2020 06:03:07
1273022,RS Tk. IV 01.07.01,5,0,0,0,0,0,5,0,17/Apr/2020 10:07:12
1273055,RS Umum Vita Insani,0,5,15,20,15,5,-20,0,24/Jul/2018 12:08:10
1273102,RS Umum Horas Insani,8,2,2,4,2,2,4,0,05/Mar/2019 10:46:16
1274012,RS Umum Daerah Dr. H. Kumpulan Pane,221,56,39,95,57,67,126,0,02/Mar/2019 03:08:04
1275013,RS Umum Daerah Dr. Pirngadi,370,30,34,64,0,0,306,0,08/Mar/2019 11:25:00
1275035,RS Tk. II Putri Hijau Medan,203,19,18,37,68,98,166,0,19/Apr/2020 04:37:07
1275046,RS Bhayangkara Medan,2,1,1,2,0,0,0,0,08/Mar/2018 12:55:44
1275072,RS Umum Santa Elisabeth Medan,233,5,9,14,0,0,219,0,15/Apr/2020 03:49:21
1275094,RS Umum Advent Medan,5,0,0,0,2,3,5,0,13/Apr/2020 10:02:24
1275126,RS Umum Methodist,95,10,5,15,31,49,80,0,08/Mar/2018 01:00:39
1275152,RS Umum Lanu Dr. Abd. Malik,12,0,0,0,9,12,12,0,08/Mar/2018 12:38:27
1275196,RS Umum Sari Mutiara,0,0,0,0,0,0,0,0,08/Mar/2018 12:37:40
1275221,RS Jiwa Prof. Dr. Muhammad Ildrem,441,232,68,300,71,70,141,0,19/Apr/2020 18:59:01
1275265,RS Umum Sundari,137,8,25,33,55,52,104,0,17/Apr/2020 09:23:47
1275276,RS Umum Vina Estetica,64,0,0,0,2,2,64,0,19/Dec/2018 09:58:39
1275590,RS Umum Bhakti,0,0,0,0,1,1,0,0,08/Mar/2018 12:39:39
1275600,RS Umum Prima Husada Cipta Medan,83,34,23,57,10,16,26,0,31/Jan/2019 12:36:00
1275633,RS Umum Martha Friska,4,3,0,3,1,0,1,0,08/Mar/2018 12:39:45
1275655,RSUP H. Adam Malik,788,122,94,216,0,0,572,0,19/Apr/2020 01:29:01
1275794,RS Umum Haji Medan,251,27,27,54,107,83,197,0,09/Mar/2018 06:29:50
1275996,RS Umum Sufina Azis,2,0,0,0,0,0,2,0,17/Apr/2020 11:36:17
1276014,RS Umum Daerah Dr. R. M. Djoelham Binjai,145,0,0,0,0,0,145,0,19/Feb/2019 09:14:35
1276040,RS Tk IV 01.07.02 Binjai,64,12,11,23,4,2,41,0,17/Jan/2019 11:00:07
1301010,RS Umum Daerah Kep. Mentawai,66,0,0,0,0,0,66,0,28/Feb/2018 08:38:06
1302011,RS Umum Daerah Dr. Muhammad Zein Painan,181,13,19,32,59,88,149,0,17/Apr/2020 06:44:58
1303012,RS Umum Daerah Muara Labuh,40,4,13,17,10,17,23,0,19/Nov/2018 08:04:11
1303023,RS Umum Daerah Arosuka Solok,100,42,40,82,12,16,18,0,16/Feb/2018 12:29:35
1311013,RS Umum Daerah Sungai Dareh,144,11,11,22,51,71,122,0,07/Apr/2020 04:09:46
1305014,RS Umum Daerah Prof Dr M.A Hanafiah,192,44,51,95,0,-15,97,0,26/Mar/2020 11:51:28
1306015,RS Umum Daerah Pariaman,147,0,0,0,69,77,147,0,15/Apr/2020 10:31:18
1308016,RS Umum Daerah Lubuk Basung,155,23,12,35,51,69,120,0,17/Apr/2020 03:50:06
1308010,RS Umum Daerah dr. Achmad Darwis,101,23,26,49,20,32,52,0,31/Oct/2018 05:14:57
1309011,RS Umum Daerah Lubuk Sikaping,197,0,0,0,0,0,197,0,17/Apr/2020 03:21:52
1309022,RS Umum Islam Ibnu Sina,127,21,28,49,0,0,78,0,08/Mar/2019 14:19:24
1312024,RS Umum Daerah Pasaman Barat,128,28,25,53,33,43,75,0,03/Apr/2020 04:20:12
1371010,RSUP Dr. M. Djamil,800,168,181,349,0,0,451,0,19/Apr/2020 22:33:02
1371021,RS Tk III Reksodiwiryo Padang,176,52,63,115,33,40,61,0,01/Aug/2018 08:31:10
1371112,RS Umum Aisyiyah Padang,55,1,5,6,1,19,49,0,11/Apr/2020 09:58:14
1371316,RS Jiwa Prof.Dr. Hasan Basri Saanin Datuk Tan Pari,314,136,26,162,109,43,152,0,30/Dec/2018 02:49:02
1371400,RS Ibu dan Anak Lenggogeni,29,0,0,0,0,0,29,0,17/Dec/2018 06:44:53
1372011,RS Umum Daerah Mohammad Natsir,274,43,71,114,63,99,160,0,16/Apr/2020 10:07:15
1373012,RS Umum Daerah Sawah Lunto,111,5,5,10,0,0,101,0,17/Apr/2020 01:30:36
1374013,RS Umum Daerah Padang Panjang,204,19,20,39,31,56,165,0,05/Nov/2019 07:37:28
1374024,RS Umum Ibnu Sina Padang Panjang,47,8,9,17,0,0,30,0,07/Apr/2020 23:26:59
1375014,RS Umum Daerah Dr. Achmad Mochtar,381,45,23,68,142,169,313,0,13/Apr/2020 12:45:22
1375036,RS Stroke Nasional,149,29,43,72,0,0,77,0,08/Mar/2019 21:58:01
1375040,RS Umum Ibnu Sina Bukittinggi,150,17,36,53,0,0,97,0,01/Apr/2020 13:07:30
1376015,RS Umum Daerah Dr Adnaan WD,95,32,46,78,6,11,17,0,15/Feb/2018 07:16:52
1401011,RS Umum Daerah Teluk Kuantan,103,9,14,23,36,44,80,0,19/Apr/2020 07:52:33
1402012,RS Umum Daerah  Indrasari Rengat,158,29,64,93,0,0,65,0,13/Apr/2020 12:36:43
1403013,RS Umum Daerah  Puri Husada Tembilahan,166,28,35,63,46,57,103,0,16/Apr/2020 07:14:45
1404014,RS Umum Daerah  Selasih Riau,116,14,13,27,27,48,89,0,19/Oct/2017 10:21:58
1405015,RS Umum Daerah Tengku Rafi'an Siak Sri Indrapura,163,26,36,62,0,0,101,0,13/Apr/2020 23:21:33
1406016,RS Umum Daerah  Bangkinang,155,14,21,35,0,0,120,0,06/Apr/2020 12:48:18
1406031,RS Umum  Tandun,50,14,13,27,0,0,23,0,14/Apr/2020 05:46:27
1407011,RS Umum Daerah  Rokan Hulu,146,85,101,186,0,0,-40,0,19/Apr/2020 08:44:57
1408011,RS Umum Daerah  Bengkalis,203,36,42,78,9,9,125,0,05/Mar/2019 12:38:21
1409022,RS Umum Daerah  Dr. R.M. Pratomo Bagansiapiapi,136,44,44,88,0,0,48,0,03/Apr/2020 16:05:19
1408032,RS Umum Daerah  Kec.Mandau,199,28,20,48,61,89,151,0,14/Apr/2020 02:53:37
1408055,RS Umum  Mutia Sari,60,5,18,23,0,0,37,0,08/Apr/2020 10:33:04
1471011,RS Umum Daerah  Arifin Achmad,610,127,153,280,0,0,330,0,18/Apr/2020 16:00:02
1471022,RS Tk IV Pekanbaru,3,0,0,0,1,1,3,0,14/Apr/2020 07:31:10
1471033,RS Bhayangkara Pekan Baru Polda Riau,61,1,3,4,17,25,57,0,15/Apr/2020 10:25:30
1471055,RS Santa Maria Pekanbaru,200,20,16,36,73,94,164,0,16/Apr/2020 07:36:02
1471135,RS Umum  Islam Ibnu Sina,10,3,3,6,1,3,4,0,13/Apr/2020 01:17:46
1471146,RS Jiwa Tampan,465,233,81,314,0,0,151,0,08/Mar/2019 14:24:17
1471150,RS Prof. Dr. Tabrani,7,3,4,7,0,0,0,0,20/Dec/2018 05:25:14
1471161,RS Umum  Bina Kasih,2,0,0,0,0,0,2,0,06/Apr/2018 01:53:29
1471215,RSU TNI-AU Lanud Roesmin Nurjadin,7,0,0,0,0,0,7,0,06/Apr/2018 12:52:56
1471226,RS Umum  Awal Bros Pekanbaru,10,5,2,7,1,1,3,1,07/Apr/2018 00:00:00
1471237,RS Ibu dan Anak Eria Bunda,5,0,0,0,0,0,5,0,06/Apr/2018 02:01:20
1471259,RS Ibu dan Anak Andini,35,0,13,13,0,22,22,0,19/Apr/2020 21:57:05
1473013,RS Umum Daerah  Kota Dumai,293,75,105,180,0,0,113,0,01/Apr/2020 12:26:19
1501012,RS Umum Daerah Mayjen H. A. Thalib,161,66,78,144,5,12,17,0,18/Apr/2020 06:49:25
1508013,RS Umum Daerah Sultan Thaha Saifuddin,131,17,16,33,44,53,98,0,15/Apr/2020 06:54:51
1502014,RS Umum Daerah Kolonel Abundjani/Bangko,142,18,15,33,42,67,109,0,18/Apr/2020 02:29:10
1503036,RS Umum Daerah Prof. Dr. H.  Chatib Quzwain,157,11,27,38,53,66,119,0,19/Apr/2020 02:21:19
1504015,RS Umum Daerah Haji Abdoel Madjid Batoe,135,17,30,47,40,48,88,0,18/Apr/2020 03:38:57
1505016,RS Umum Daerah Ahmad Ripin,116,1,0,1,35,0,115,0,18/Apr/2020 06:20:45
1507010,RS Umum Daerah KH. Daud Arif,99,11,22,33,18,25,66,0,17/Apr/2020 07:18:20
1506011,RS Umum Daerah Nurdin Hamzah,56,9,18,27,11,10,29,0,14/Apr/2020 08:59:57
1509013,RS Umum Daerah H. Hanafie,212,38,23,61,63,90,151,0,16/Apr/2020 04:32:49
1571012,RS Umum Daerah Raden Mattaher Jambi,332,37,30,67,119,135,265,0,18/Apr/2020 05:56:13
1571023,RS Tk. IV dr. Bratanata,232,34,28,62,12,28,170,0,18/Apr/2020 04:18:16
1571034,RS Bhayangkara Jambi,104,11,30,41,0,6,63,0,19/Apr/2020 03:11:09
1571045,RS Umum Santa Theresia,100,9,20,29,0,13,71,0,13/Apr/2020 01:13:34
1571136,RS Jiwa Daerah Provinsi Jambi,316,3839,1632,5471,3835,1632,-5155,0,01/Mar/2019 06:04:02
1571147,RS Siloam Jambi,0,0,0,0,0,0,0,0,17/Apr/2020 12:02:08
1571158,RS Umum Daerah H. Abdul Manap,160,8,17,25,64,71,135,0,19/Apr/2020 03:34:08
1601013,RS Umum Daerah Dr. Ibnu Sutowo Baturaja,164,10,25,35,60,68,129,0,18/Apr/2020 02:17:17
1609083,RS Umum Daerah Ogan Komering Ulu Timur,150,9,16,25,49,76,125,0,18/Apr/2020 04:29:37
1602014,RS Umum Daerah Kayuagung,241,13,31,44,92,105,197,0,18/Apr/2020 05:07:48
1672015,RS Umum Daerah Kota Prabumulih,166,57,68,125,14,27,41,0,04/Mar/2019 06:16:54
1603063,RS Umum Daerah dr. H. M. Rabain Muara Enim,175,39,45,84,32,55,91,0,22/Nov/2018 07:47:36
1672074,RS AR Bunda Kota Prabumulih,211,33,45,78,0,0,133,0,19/Apr/2020 03:37:09
1603085,RS Umum Daerah Talang Ubi,73,5,13,18,25,30,55,0,01/Apr/2020 07:47:06
1604016,RS Umum Daerah Lahat,219,66,80,146,34,34,73,0,11/Apr/2020 04:18:49
1673031,RS Umum Daerah Basemah Kota Pagar Alam,163,17,21,38,58,67,125,0,17/Apr/2020 04:30:51
1674010,RS Umum Daerah Dr. Sobirin Kabupaten Musi Rawas,162,45,37,82,29,34,80,0,15/Apr/2020 07:01:25
1674032,RS Umum Daerah Siti Aisyah Kota Lubuk Linggau,129,62,42,104,0,0,25,0,01/Mar/2019 06:22:16
1605043,RS Umum Daerah Rupit Kabupaten Musi Rawas Utara,94,17,10,27,28,39,67,0,01/Apr/2020 04:48:09
1606011,RS Umum Daerah Sekayu,272,0,0,0,0,0,272,0,05/Mar/2019 04:36:18
1606022,RS Umum Daerah Sungai Lilin,66,22,20,42,8,13,24,0,28/Feb/2019 04:57:26
1606032,RS Umum Daerah Bayung Lincir,46,8,15,23,10,13,23,0,28/Feb/2019 05:59:31
1607012,RS Umum Daerah Banyuasin,102,50,40,90,8,4,12,0,28/Feb/2018 03:20:18
1608051,RS Umum Daerah Muara Dua,80,19,15,34,31,49,46,0,13/Mar/2018 08:53:09
1671013,RS Umum Pusat Dr. Mohammad Hoesin Palembang,971,152,202,354,0,0,617,0,07/Aug/2018 13:48:24
1671024,RS Umum Pertamina Palembang,64,7,11,18,19,25,46,0,11/Apr/2020 07:09:06
1671035,RS Umum dr. AK.Gani Kota Palembang,242,21,32,53,0,0,189,0,18/Apr/2020 02:25:55
1671050,RS Umum RK Charitas,7,0,0,0,0,0,7,0,17/Apr/2020 08:41:00
1671061,RS Jiwa Ernaldi Bahar Provinsi Sumatera Selatan,196,87,18,105,57,38,91,0,16/Apr/2020 13:28:50
1671243,RS Umum Bunda Palembang,142,10,31,41,23,59,101,0,13/Apr/2020 11:24:55
1671254,RS Ibu dan Anak Tiara Fatrin Palembang,203,51,62,113,0,50,90,0,04/Jul/2017 14:48:09
1671265,RS Umum Daerah Palembang Bari,258,31,38,69,73,115,189,0,18/Apr/2020 03:39:55
1671301,RS Muhammadiyah Palembang,215,33,58,91,73,61,124,0,13/Apr/2020 02:57:23
1671312,RS Khusus Paru Palembang,35,0,0,0,19,16,35,0,19/Apr/2020 01:13:03
1671323,RS Khusus Mata Masyarakat Provinsi Sumatera Selat,35,0,0,0,18,17,35,0,01/Apr/2020 09:30:58
1701014,RS Umum Daerah Hasanuddin Damrah Manna,155,0,0,0,0,0,155,0,11/Feb/2019 05:57:15
1702015,RS Umum Daerah Curup,174,22,40,62,27,44,112,0,15/Apr/2020 04:35:29
1707026,RS Umum Daerah Lebong,59,9,8,17,18,24,42,0,24/Mar/2020 06:32:47
1703016,RS Umum Daerah Arga Makmur,250,58,27,85,84,73,165,0,17/Apr/2020 09:43:18
1703027,RS Bergerak Enggano,10,1,0,1,4,5,9,0,28/Feb/2019 04:26:59
1706019,RS Umum Daerah Mukomuko,136,28,34,62,37,38,74,0,04/Mar/2019 06:34:18
1708010,RS Umum Daerah Kepahiang,195,32,25,57,63,79,138,0,21/Feb/2018 12:02:45
1771014,RS Umum Daerah Dr. M. Yunus Bengkulu,325,30,35,65,124,129,260,0,11/Apr/2020 11:33:09
1771025,RS Jiwa Soeprapto Provinsi Bengkulu,300,98,26,124,123,49,176,0,25/Feb/2019 05:11:55
1771040,RS Tk. IV Bengkulu,75,25,33,58,8,9,17,0,17/Jan/2019 08:03:27
1771051,RS Bhayangkara Jitra Kota Bengkulu,110,19,13,32,39,39,78,0,17/Apr/2020 06:05:24
1801015,RS Umum Daerah Alimuddin Umar,141,41,34,75,26,33,66,0,17/Apr/2020 14:22:19
1802016,RS Panti Secanti,75,1,6,7,17,21,68,0,11/Apr/2020 04:30:38
1802027,RS Umum Daerah Batin Mangunang,99,15,7,22,8,20,77,0,14/Apr/2020 04:09:10
1802038,RS Umum Mitra Husada,138,21,22,43,47,48,95,0,19/Apr/2020 11:47:32
1803010,RS Umum Daerah Pringsewu,146,24,25,49,48,49,97,0,17/Apr/2020 12:10:48
1803021,RS Umum Daerah Dr. H. Bob Bazar SKM,177,29,47,76,55,46,101,0,15/Apr/2020 03:53:00
1804011,RS Umum Daerah Sukadana,100,46,54,100,46,54,0,0,23/Feb/2018 10:58:09
1805012,RS Umum Mitra Mulia Husada,43,6,2,8,6,2,35,0,18/Apr/2020 06:29:38
1805023,RS Umum Yukum Medical Centre,147,18,11,29,72,89,118,0,18/Apr/2020 01:59:07
1806013,RS Umum Daerah May Jen HM Ryacudu,139,19,21,40,42,48,99,0,19/Apr/2020 03:36:27
1805024,RS Umum Islam Asy-Syifaa Bandar Jaya,89,6,13,19,33,37,70,0,19/Apr/2020 08:14:57
1807014,RS Umum Daerah Zainal Abidin Pagar Alam,45,6,9,15,14,17,30,0,19/Apr/2020 01:59:07
1808015,RS Umum Daerah Menggala Tulang Bawang,121,1,0,1,19,21,120,0,13/Feb/2018 10:06:01
1801017,RS Umum Daerah Dr H Abdul Moeloek,612,93,97,190,0,0,422,0,04/Mar/2019 10:15:01
1871176,RS Jiwa Bandar Lampung,125,68,17,85,25,15,40,0,08/Mar/2019 04:21:22
1871282,RS Umum Advent Bandar Lampung,38,0,0,0,0,0,38,0,01/Jan/1970 07:00:00
1871405,RS Umum Urip Sumoharjo,426,52,65,117,0,0,309,0,16/Apr/2020 05:52:26
1872016,RS Umum Daerah Ahmad Yani Metro,224,66,72,138,42,44,86,0,17/Apr/2020 04:22:30
1901016,RS Umum Daerah Depati Bahrin,158,19,18,37,52,69,121,0,18/Apr/2020 06:56:18
1901020,RS  Jiwa Sungai Liat,152,68,21,89,112,40,63,0,26/Feb/2018 08:08:54
1902010,RS Umum Daerah dr. H. Marsidi Judono,144,34,43,77,0,0,67,0,15/May/2018 09:42:05
1904013,RS Umum Daerah Kab.Bangka Tengah,76,36,36,72,2,2,4,0,08/Feb/2018 09:30:26
1903013,RS Umum Daerah Sejiran Setason,96,8,18,26,28,42,70,0,14/Apr/2020 07:40:47
1905024,RS Umum Daerah Kab. Bangka Selatan,24,0,0,0,0,0,24,0,13/Feb/2018 12:54:34
1906014,RS Umum Daerah  Kab.Belitung Timur,125,12,16,28,37,45,97,0,15/Apr/2020 06:52:43
1971021,RS Umum Daerah Depati Hamzah,11,0,0,0,0,0,11,0,13/Feb/2018 01:03:26
1971043,RS Bakti Timah Pangkalpinang,137,44,43,87,20,30,50,0,18/Apr/2020 03:59:02
2002010,RS Umum Daerah Tanjung Uban,94,26,28,54,16,20,40,0,02/Aug/2018 08:14:45
2003011,RS Umum Daerah Natuna,84,12,17,29,20,35,55,0,06/Mar/2019 04:52:43
2072012,RS Umum Daerah Kota Tanjung Pinang,129,14,19,33,42,54,96,0,18/Apr/2020 04:27:23
2001045,RS Umum Bhakti Timah,85,15,38,53,0,0,32,0,01/Jan/2019 06:38:55
2003056,RSAU dr. Yuniati Wisma Karyani,28,0,0,0,15,13,28,0,17/Apr/2020 04:42:40
2001013,RS Umum Daerah Muhammad Sani Kabupaten Karimun,187,25,25,50,0,0,137,0,06/Mar/2019 20:26:51
2071034,RS Badan Pengusahaan Batam,196,0,0,0,0,0,196,0,16/Apr/2020 15:44:18
2071114,RS Umum Daerah Embung Fatimah Kota Batam,224,16,14,30,76,118,194,0,09/Jan/2019 06:29:06
2003125,RS Umum Daerah Palmatak,42,2,2,4,16,24,38,0,01/Apr/2018 04:35:06
2004136,RS Umum Daerah Encik Mariyam,27,11,7,18,5,6,9,0,08/Feb/2018 08:57:39
3171012,RSUP Fatmawati,678,83,83,166,0,0,512,0,19/Apr/2020 06:40:03
3171034,RS Umum AL Cilandak,15,0,0,0,0,0,15,0,16/Apr/2020 12:42:45
3171045,RS Umum Jakarta,4,0,0,0,2,2,4,0,17/Apr/2020 06:28:02
3171435,RS Ketergantungan Obat,150,33,2,35,6,0,115,0,01/Apr/2020 06:28:29
3171450,RS Umum Setia Mitra,61,5,12,17,19,25,44,0,24/Dec/2018 09:20:46
3171504,RS Umum Pondok Indah,88,21,18,39,0,33,49,0,17/Apr/2020 07:04:41
3171702,RS Umum Zahirah,3,1,2,3,0,0,0,0,12/Oct/2017 11:50:30
3171757,RS Ibu dan Anak Brawijaya Durentiga,29,0,5,5,0,20,24,0,24/Dec/2018 09:43:19
3172013,RSUP Persahabatan,585,18,3,21,0,0,564,0,19/Apr/2020 22:35:32
3172024,RS Umum Daerah Budhi Asih,430,110,124,234,0,30,196,0,17/Apr/2018 18:37:56
3172072,RS Umum Bhayangkara Tk. I R.Said Sukanto,76,0,0,0,0,0,76,0,13/Apr/2020 05:00:14
3172505,RS Islam Jakarta Pondok Kopi,14,0,0,0,0,0,14,0,01/Apr/2020 10:10:15
3172520,RS Umum Harum,11,0,0,0,0,0,11,0,17/Apr/2020 14:15:10
3172553,RS Umum Harapan Bunda,7,1,0,1,0,0,6,0,17/Apr/2020 10:21:48
3172713,RS Umum Mediros,11,1,0,1,6,4,10,0,09/Jan/2019 11:43:53
3172735,RS Jiwa Islam Klender,50,15,12,27,15,8,23,0,01/Mar/2019 07:43:25
3172746,RS Jiwa Duren Sawit,116,22,34,56,35,25,60,0,18/Apr/2020 06:54:35
3173014,RSUPN Dr. Cipto Mangunkusumo,1091,362,352,714,0,0,377,1901,01/Aug/2018 08:41:15
3173036,RS Umum AL Dr Mintoharjo,37,7,5,12,0,0,25,0,17/Apr/2020 04:41:00
3173040,RS Umum Husada,24,0,0,0,0,0,24,0,14/Apr/2020 14:51:10
3173051,RS Umum Sint Carolus,32,0,0,0,0,0,32,0,17/Apr/2020 08:10:31
3173062,RS PGI Cikini,314,23,27,50,0,0,264,0,17/Apr/2020 02:20:00
3173084,RS Tk II M.Ridwan Meuraksa,135,75,55,130,15,35,5,0,17/Apr/2020 14:55:21
3173105,RS Umum Budi Kemuliaan,15,0,9,9,2,2,6,0,15/Apr/2020 11:08:33
3173120,RS Khusus Ibu Anak Bunda Jakarta,81,6,42,48,2,31,33,0,26/Dec/2018 08:39:39
3173441,RS Umum Evasari,1,0,0,0,0,0,1,0,16/Apr/2020 11:15:16
3173474,RS Umum Pertamina Jaya,170,14,9,23,0,0,147,0,18/Apr/2020 09:02:02
3173521,RS Umum Daerah Tarakan,696,227,208,435,285,285,261,0,10/Nov/2017 03:00:25
3173580,RS Umum Kramat 128,8,0,0,0,0,0,8,0,16/Apr/2020 10:05:13
3173612,RS Khusus THT Prof Nizar,0,0,0,0,0,0,0,0,18/Apr/2020 08:15:50
3173645,RS Umum Menteng Mitra Afia,2,0,0,0,0,0,2,0,17/Apr/2020 13:41:50
3174041,RS Jiwa Dr. Soeharto Heerjan,367,132,73,205,0,0,162,0,15/Apr/2020 06:39:49
3174063,RS Kanker Dharmais,441,107,117,224,159,58,217,0,08/Mar/2019 23:32:18
3174260,RS Anak dan Bunda Harapan Kita,477,31,226,257,0,207,220,0,03/Mar/2019 03:19:35
3174431,RS Umum Hermina Daan Mogot,3,0,0,0,0,0,3,0,18/Apr/2020 20:10:54
3175016,RS Umum Daerah Koja,927,108,125,233,52,68,694,0,01/Dec/2017 18:59:28
3175064,RS Penyakit Infeksi Prof. Dr. Sulianti Saroso,176,35,35,70,0,0,106,0,09/Mar/2019 00:00:02
3175181,RS Umum Sukmul,5,0,0,0,0,0,5,0,17/Apr/2020 13:42:02
3175304,RS Umum Hermina Podomoro,56,18,18,36,9,26,20,0,14/Apr/2020 01:26:30
3175330,RS Umum Royal Progress,4,0,0,0,0,0,4,0,17/Apr/2020 11:08:58
3175341,RS Umum Pluit,139,0,0,0,0,0,139,0,18/Dec/2018 07:12:10
3175363,RS Ibu dan Anak Family,1,0,0,0,0,0,1,0,17/Apr/2020 12:40:50
3175374,RS Umum Puri Medika,4,0,0,0,0,0,4,0,16/Apr/2020 13:27:26
3201024,RS Paru Dr. M. Goenawan Partowidigdo,201,37,14,51,0,0,150,0,19/Apr/2020 19:47:44
3201046,RS Umum Daerah Cibinong,325,107,102,209,135,84,116,0,06/Mar/2019 14:30:22
3201050,RS Umum Daerah Ciawi,271,71,42,113,0,0,158,0,04/Mar/2019 03:10:00
3201218,RS Umum Islam Bogor,123,21,16,37,0,86,86,0,13/Apr/2020 05:17:05
3202014,RS Umum Daerah Sekarwangi,311,89,94,183,54,67,128,0,17/Apr/2020 04:57:08
3202040,RS Umum Daerah Palabuhanratu,217,48,55,103,33,26,114,0,14/Apr/2020 06:10:13
3202051,RS Umum Daerah Jampang Kulon,190,45,40,85,11,23,105,0,13/Apr/2020 06:48:30
3202062,RS Umum Hermina,137,52,59,111,5,21,26,0,19/Apr/2020 06:29:21
3203015,RS Umum Daerah Sayang,819,114,122,236,0,0,583,3,15/Apr/2020 14:50:17
3203037,RS Umum Daerah Cimacan,145,23,18,41,0,0,104,0,14/Apr/2020 02:55:00
3204016,RS Umum Daerah Majalaya,95,37,43,80,10,11,15,0,19/Apr/2020 01:07:48
3277020,RS Umum Daerah Cibabat,285,71,76,147,54,77,138,0,18/Apr/2020 07:09:11
3217042,RS Jiwa Provinsi Jawa Barat,162,38,42,80,48,34,82,0,28/Nov/2018 03:48:24
3204075,RS Umum Mitra Kasih,2,0,0,0,0,0,2,0,16/Apr/2020 11:31:23
3204086,RS Umum Daerah Al Ihsan Provinsi Jawa Barat,325,80,62,142,79,79,183,0,02/Apr/2020 10:41:44
3204090,RS Umum Daerah Soreang,209,50,66,116,47,60,93,0,07/Nov/2018 06:48:09
3204101,RS Umum Daerah Cicalengka,94,34,58,92,0,0,2,0,14/Apr/2020 07:36:48
3205010,RS Umum Daerah dr. Slamet Garut,600,196,240,436,208,31,164,0,19/Apr/2020 22:36:56
3206011,RS Umum Daerah dr. Soekardjo,458,67,96,163,89,47,295,0,06/Apr/2020 11:47:59
3278081,RS Umum Prasetya Bunda,52,0,0,0,0,0,52,0,04/Apr/2020 05:41:36
3207012,RS Umum Daerah Kab. Ciamis,363,117,110,227,41,60,136,0,07/Mar/2019 05:33:52
3207023,RS Umum Daerah Banjar,32,14,13,27,5,0,5,0,26/Mar/2018 06:29:20
3208013,RS Umum Daerah 45 Kuningan,172,0,0,0,0,0,172,0,18/Apr/2020 03:00:54
3208024,RS Umum Wijaya Kusumah,2,0,0,0,0,0,2,0,18/Apr/2020 10:22:34
3209014,RS Umum Daerah Waled,573,106,161,267,154,146,306,0,02/Nov/2018 07:30:48
3209025,RS Pertamina Cirebon,0,0,0,0,0,0,0,0,18/Apr/2020 07:50:03
3209036,RS Paru Provinsi Jawa Barat,101,4,3,7,49,45,94,0,19/Apr/2020 12:14:25
3209040,RS Umum Daerah Arjawinangun,411,92,121,213,72,101,198,0,08/Mar/2019 18:28:10
3210014,RS Umum Daerah Majalengka,192,48,57,105,0,0,87,0,19/Apr/2020 21:59:57
3210025,RS Umum Daerah Cideres,284,95,111,206,0,0,78,0,19/Apr/2020 22:00:01
3210036,RS Bedah Budi Kasih,18,1,0,1,17,0,17,0,19/Apr/2020 22:05:01
3211015,RS Umum Daerah Sumedang,189,0,0,0,0,0,189,0,18/Apr/2020 12:13:33
3212016,RS Umum Daerah Kab. Indramayu,330,69,107,176,71,81,154,0,28/Nov/2018 08:24:46
3212031,RS Umum Daerah M.A. Sentot Patrol,96,36,33,69,16,8,27,0,04/Mar/2019 07:55:34
3213010,RS Umum Daerah Subang,351,115,143,258,0,0,93,0,05/Apr/2020 05:27:18
3214011,RS Umum Daerah Bayu Asih,221,43,45,88,58,75,133,0,17/Apr/2020 05:20:25
3215012,RS Umum Daerah Karawang,397,63,93,156,0,0,241,0,18/Apr/2020 09:00:00
3215023,RS Umum Bayukarta,144,10,20,30,56,51,114,0,19/Apr/2020 04:07:24
3215056,RS Umum Karya Husada,23,5,5,10,18,18,13,0,06/Apr/2020 14:01:01
3215078,RS Umum Islam Karawang,49,9,25,34,6,9,15,0,07/Jan/2019 07:47:32
3215100,RS Umum Delima Asih Sisma Medika,77,11,14,25,0,5,52,0,15/Apr/2020 09:56:21
3215112,RS Ibu dan Anak Dr. Djoko Pramono,32,3,17,20,0,12,12,0,08/Mar/2019 04:29:05
3215145,RS Umum Mandaya,48,0,0,0,0,0,48,0,07/Feb/2019 11:43:02
3275013,RS Umum Daerah dr. Chasbullah Abdulmadjid,709,316,336,652,23,47,57,0,01/Mar/2019 05:39:14
3216072,RS Umum Bhakti Husada,3,0,0,0,0,0,3,0,17/Apr/2020 08:01:02
3275115,RS Umum Hermina Bekasi,3,0,0,0,0,0,3,0,18/Apr/2020 15:40:53
3216126,RS Umum Annisa,243,0,0,0,0,0,243,0,16/Apr/2020 10:51:01
3216163,RS Umum Sentra Medika,165,70,8,78,0,0,87,0,19/Apr/2020 07:08:28
3275207,RS Umum Graha Juanda,65,3,17,20,15,26,45,0,16/Apr/2020 05:45:48
3275229,RS Umum Anna,5,2,3,5,0,0,0,0,09/Apr/2020 02:05:19
3216252,RS Umum Daerah Kab.Bekasi,115,59,59,118,28,28,-3,0,17/Apr/2020 05:23:45
3275307,RS Siloam Bekasi Sepanjang Jaya,96,18,28,46,30,21,50,0,14/Apr/2020 10:45:54
3216318,RS Umum Hermina Grand Wisata,157,0,1,1,0,0,156,0,15/Apr/2020 11:39:35
3271013,RS Umum PMI Bogor,223,81,93,174,15,31,49,0,18/Apr/2020 05:17:09
3271035,RS Umum Dr Muhamad Hassan Toto,144,31,38,69,43,32,75,0,04/Jan/2019 02:47:13
3271046,RS Jiwa dr. H. Marzoeki Mahdi,695,254,115,369,151,86,326,0,09/Feb/2018 01:59:56
3271072,RS Umum Azra,121,6,10,16,0,0,105,0,19/Apr/2020 22:35:49
3271104,RS Umum Daerah Kota Bogor,325,5,5,10,0,0,315,0,06/Feb/2018 08:43:59
3271115,RS Umum Hermina Bogor,176,11,31,42,57,77,134,0,18/Apr/2020 06:40:52
3271139,RS Umum Trimitra,76,0,0,0,0,0,76,0,20/Dec/2018 07:18:52
3272014,RS Umum Daerah  R Syamsudin SH,609,133,108,241,153,215,368,0,18/Apr/2020 05:00:58
3272036,RS Umum Ridogalih,51,2,3,5,23,23,46,0,17/Apr/2020 04:17:22
3273015,RS Umum Pusat Dr. Hasan Sadikin,981,129,116,245,0,0,736,749,08/Mar/2019 07:56:20
3273026,RSU Bhayangkara Tk II Sartika Asih,200,40,47,87,0,0,113,0,18/Apr/2020 10:27:31
3273030,RS Umum Lanud dr. M. Salamun,9,9,0,9,0,0,0,0,15/Apr/2020 07:09:42
3204041,RS Umum Kebonjati,187,63,59,122,5,11,65,0,04/Jul/2017 14:48:09
3273052,RS Umum Immanuel Bandung,874,320,206,526,14,47,348,0,07/Nov/2017 13:10:40
3273063,RS Umum Santo Yusup,11,0,0,0,0,0,11,0,16/Apr/2020 11:33:15
3273121,RS Umum Rajawali,839,242,282,524,17,47,315,0,04/Jul/2017 14:48:09
3273191,RS Khusus Mata Cicendo,104,20,17,37,0,0,67,32,19/Feb/2019 09:55:43
3273201,RS Paru Dr. H. A. Rotinsulu,116,34,20,54,0,0,62,1,19/Apr/2020 08:47:17
3273260,RS Ibu dan Anak Kota Bandung,51,0,20,20,0,23,31,0,08/Mar/2019 18:09:14
3273405,RS Umum Daerah Kota Bandung,212,36,43,79,40,42,133,0,19/Apr/2020 21:22:45
3273420,RS Umum Al-Islam Bandung,265,0,0,0,58,74,265,38,15/Sep/2018 01:06:15
3273453,RS Khusus Ginjal NY R.A. Habibie,844,246,282,528,14,51,316,0,04/Jul/2017 14:48:09
3273486,RS Umum Santosa Hospital Bandung Central,362,78,71,149,0,0,213,0,17/Apr/2020 10:55:31
3273528,RS Ibu dan Anak Melinda,839,242,282,524,17,47,315,0,04/Jul/2017 14:48:09
3273539,RS Umum Hermina Pasteur,154,36,40,76,27,51,78,0,19/Apr/2020 10:54:20
3274016,RS Umum Daerah Gunung Jati,290,69,32,101,190,190,189,0,14/Apr/2020 15:31:12
3209133,RS Umum Sumber Waras,0,0,0,0,0,0,0,0,17/Apr/2020 10:29:27
3276124,RS Umum Daerah Kota Depok,49,27,27,54,24,24,-5,7,14/Apr/2020 02:22:02
3276135,RS Umum Simpangan Depok,22,12,12,24,10,10,-2,0,19/Apr/2020 15:01:01
3276146,RS Umum Hasanah Graha Afiah,129,8,18,26,44,62,103,0,15/Apr/2020 12:00:44
3301014,RS Umum Daerah Cilacap,264,45,52,97,0,0,167,0,19/Apr/2020 00:14:42
3301036,RS Umum Pertamina Cilacap,54,5,6,11,21,21,43,0,17/Apr/2020 11:06:44
3301073,RS Umum Islam Fatimah,123,45,45,90,78,78,33,0,19/Apr/2020 22:01:01
3301084,RS Umum Daerah Majenang,162,38,30,68,41,53,94,0,18/Apr/2020 12:43:39
3301095,RS Bersalin Annisa,25,0,1,1,0,24,24,0,06/Feb/2018 10:56:29
3302015,RSUD BANYUMAS,451,103,95,198,0,0,253,0,19/Apr/2020 02:02:35
3302026,RS Umum Daerah Prof Dr. Margono Soekarjo Purwoker,693,122,106,228,158,219,465,0,09/Feb/2018 11:03:54
3302030,RS Umum Tk III Wijayakusuma,18,0,0,0,0,0,18,0,19/Apr/2020 14:54:28
3302041,RS Umum Santa Elisabeth Purwokerto,10,1,1,2,0,0,8,0,17/Apr/2020 13:45:33
3302143,RS Umum Hidayah Purwokerto,52,10,17,27,14,11,25,0,02/Jan/2019 02:27:50
3302165,RS Umum Ananda Purwokerto,70,9,21,30,0,0,40,0,16/Apr/2020 14:18:58
3302191,RS Umum Daerah Ajibarang,176,25,45,70,44,47,106,0,16/Apr/2020 07:08:38
3302213,RS Umum Wiradadi Husada,7,0,0,0,0,0,7,0,18/Apr/2020 19:52:14
3303016,RS Umum Daerah dr. R. Goeteng Taroenadibrata,147,0,0,0,0,28,147,0,01/Mar/2018 05:20:01
3303075,RS Umum Harapan Ibu,74,9,8,17,26,31,57,0,19/Apr/2020 09:36:36
3304010,RS Umum Daerah Hj. Anna Lasmanah Banjarnegara,255,85,116,201,17,31,54,0,04/Feb/2019 04:35:28
3305011,RS Umum Daerah dr. Soedirman Kabupaten Kebumen,298,58,83,141,74,73,157,0,18/Apr/2020 03:31:46
3305066,RS Umum PKU Muhamadiyah Gombong,276,88,61,149,55,73,127,0,14/Apr/2020 03:49:27
3305081,RS Umum Wijayakusuma,18,0,0,0,18,18,18,0,11/Nov/2017 13:05:49
3305092,RS Umum Purbowangi,6,0,0,0,0,0,6,0,18/Apr/2020 09:54:49
3306012,RS Umum Daerah Dr. Tjitrowardojo Purworejo,319,47,54,101,82,95,218,0,04/Jul/2017 14:48:09
3306104,RS Umum Palang Biru Kutoarjo,1,0,0,0,0,0,1,0,18/Apr/2020 13:41:33
3307013,RS Umum Setjonegoro Wonosobo,218,60,56,116,44,58,102,0,31/Mar/2020 14:09:23
3307050,RS Umum Islam Wonosobo,103,34,21,55,28,20,48,0,01/Mar/2019 03:56:31
3308014,RS Umum Daerah Muntilan Kab. Magelang,157,32,38,70,34,53,87,0,19/Apr/2020 03:23:55
3309015,RS Umum Daerah Pandan Arang Boyolali,258,118,0,118,140,0,140,0,12/Jan/2019 07:01:17
3309096,RS Umum Daerah Waras Wiris,58,30,41,71,37,38,-13,0,16/Apr/2020 06:14:44
3309107,RS Umum Daerah Simo,74,42,4,46,20,8,28,0,02/Feb/2019 04:36:58
3310015,RS Umum Pusat Dr. Soeradji Tirtonegoro,361,84,68,152,0,0,209,0,17/Apr/2020 02:42:34
3310026,RS Jiwa Daerah Dr. RM. Soedjarwadi,199,62,23,85,114,0,114,0,19/Apr/2020 22:38:07
3310384,RS Umum Islam Klaten,221,70,69,139,0,0,82,0,02/Nov/2018 05:37:37
3310405,RS Khusus Bedah Diponegoro,66,13,6,19,0,0,47,0,07/Mar/2019 07:02:19
3311016,RS Umum Daerah Ir. Soekarno Kabupaten Sukoharjo,252,30,30,60,0,0,192,0,16/Feb/2019 14:00:01
3311213,RS Umum Nirmala Suri,61,30,26,56,21,21,5,0,14/Apr/2020 06:34:06
3312010,RS Umum Daerah Dr. Soediran Mangun Sumarso Wonogi,352,72,42,114,0,0,238,0,19/Apr/2020 00:11:27
3312273,RS Umum Marga Husada,58,3,3,6,0,0,52,0,06/Jan/2019 07:43:36
3312284,RS Umum Muhammadiyah Selogiri,71,7,21,28,0,0,43,0,10/Apr/2020 09:31:20
3312295,RS Umum Medika Mulya,9,1,1,2,3,2,7,0,20/Dec/2018 10:30:29
3313011,RS Umum Daerah Karanganyar,818,423,0,423,395,0,395,0,07/Jul/2018 08:00:03
3313022,RS Umum Lanuma Adisumarmo,6,0,0,0,0,0,6,0,17/Apr/2020 11:23:04
3314012,RS Umum Daerah dr. Soehadi Prijonegoro,302,52,58,110,84,105,192,0,18/Apr/2020 04:10:05
3314045,RS Umum Sarila Husada,7,0,0,0,0,0,7,0,18/Apr/2020 13:57:29
3314067,RS Umum Assalam,65,7,28,35,12,18,30,0,14/Sep/2017 12:41:22
3315024,RS Umum Panti Rahayu,8,1,3,4,3,1,4,0,17/Apr/2020 05:04:12
3316014,RS Umum Daerah Dr. R. Soetijono Blora,170,45,41,86,0,0,84,0,01/Nov/2018 09:43:16
3316025,RS Umum Daerah Dr. R. Soeprapto Cepu,157,34,27,61,0,0,96,0,27/Sep/2018 06:53:38
3316040,RS Umum Permata Blora,65,15,31,46,0,0,19,0,13/Apr/2020 20:03:05
3316051,RS Umum PKU Muhammadiyah Cepu,131,28,47,75,25,31,56,0,18/May/2018 09:30:14
3317015,RS Umum Daerah dr. R. Soetrasno Rembang,222,67,94,161,17,11,61,0,18/Apr/2020 13:10:12
3318016,RS Umum Daerah RAA Soewondo,458,83,107,190,121,143,268,40,16/Apr/2020 11:13:55
3318064,RS Umum Islam Pati,162,25,26,51,58,51,111,2,10/Apr/2018 08:04:09
3318086,RS Umum Daerah Kayen Pati,79,57,0,57,22,0,22,0,09/Mar/2019 00:13:19
3319032,RS Umum Mardi Rahayu,244,43,43,86,0,0,158,0,11/Apr/2020 10:04:55
3320010,RS Umum Daerah R. A. Kartini,60,60,0,60,0,0,0,0,15/Apr/2020 00:00:00
3320021,RS Umum Daerah Kelet Provinsi Jawa Tengah,236,50,51,101,79,75,135,0,15/Jan/2019 07:23:37
3321011,RS Umum Daerah Sunan Kalijaga,289,110,124,234,17,16,55,0,28/Oct/2018 03:29:04
3322012,RS Umum Daerah Ambarawa,176,53,65,118,0,0,58,0,05/Feb/2018 10:58:37
3322023,RS Umum Daerah Ungaran,165,12,25,37,0,0,128,0,09/Apr/2020 09:04:41
3323013,RS Umum Daerah Djojonegoro Temanggung,414,0,0,0,0,0,414,0,18/Apr/2020 04:11:00
3323050,RS Umum PKU Muhammadiyah Temanggung,95,46,30,76,0,0,19,0,23/Nov/2017 09:16:56
3324014,RS Umum Daerah  Dr. H. Soewondo Kendal,249,61,61,122,51,76,127,0,17/Apr/2020 11:18:00
3324036,RS Umum Islam Kendal,213,129,0,129,84,0,84,0,25/Jan/2018 11:01:10
3325015,RS Umum Daerah Kab. Batang,251,0,0,0,0,0,251,0,04/Apr/2020 04:24:56
3326038,RS Umum Daerah Kajen Kab.Pekalongan,131,45,45,90,86,86,41,0,19/Apr/2020 21:01:01
3326049,RS Umum Daerah Bendan Kota Pekalongan,185,38,64,102,81,74,83,0,01/Mar/2018 01:35:29
3327010,RS Umum Daerah Dr. M Ashari Pemalang,321,48,100,148,8,7,173,0,19/Apr/2020 21:52:33
3327032,RS Umum Islam Moga,48,2723,4579,7302,2723,4579,-7254,0,29/Dec/2018 07:15:46
3328055,RSU Islam PKU Muhammadiyah,14,0,0,0,0,0,14,0,18/Apr/2020 12:58:42
3329012,RS Umum Daerah Brebes,1187,0,0,0,0,0,1187,0,06/Feb/2018 06:21:27
3371014,RS Umum Daerah Tidar,337,66,96,162,89,86,175,0,17/Apr/2020 04:49:09
3371025,RS Umum Tk II Dr. Soedjono,243,38,38,76,79,88,167,0,13/Apr/2020 05:45:31
3371040,RS Jiwa Prof. Dr. Soerojo,531,97,74,171,0,0,360,0,13/Feb/2019 14:30:00
3371105,RS Ibu dan Anak Gladiool,0,0,0,0,0,0,0,0,09/Mar/2019 00:13:01
3372015,RS Umum Daerah Dr. Moewardi Surakarta,963,0,0,0,0,0,963,0,17/Apr/2020 08:42:38
3372026,RS Umum Dr. Oen,16,14,3,17,0,0,-1,0,15/Apr/2020 05:23:07
3372030,RS Umum Tk IV Slamet Riyadi Surakarta,6,0,0,0,0,0,6,0,19/Apr/2020 00:51:56
3372041,RS Umum Brayat Minulya,2,0,0,0,0,0,2,0,18/Apr/2020 07:29:32
3372052,RS Jiwa Daerah Surakarta,297,154,57,211,105,99,86,0,06/Mar/2019 07:20:00
3372063,RS Orthopedi Prof. Dr. R. Soeharso,166,14,8,22,0,0,144,134,18/Apr/2020 01:41:33
3372096,RS Umum PKU Muhammadiyah Surakarta,351,90,86,176,60,117,175,173,19/Apr/2020 00:55:15
3372132,RS Umum Islam Kustati,8,0,0,0,0,0,8,0,17/Apr/2020 09:25:05
3372165,RS Umum Kasih Ibu,200,44,52,96,57,64,104,0,16/Apr/2020 04:03:26
3372191,RS Umum Triharsi,1,0,0,0,0,0,1,0,17/Apr/2020 08:42:36
3372234,RS Umum Daerah Kota Surakarta,127,25,43,68,0,0,59,0,02/Apr/2020 06:50:05
3373016,RS Umum Daerah Salatiga,557,204,215,419,132,120,138,0,08/Mar/2019 09:03:01
3373020,RS Umum Tk. IV 04.07.03 dr. Asmir,136,18,14,32,36,66,104,0,18/Apr/2020 06:27:24
3373042,RS Paru Dr. Ario Wirawan,193,26,20,46,77,70,147,0,08/Mar/2019 09:15:59
3374010,RS Umum Pusat Dr. Kariadi,1146,173,222,395,567,141,751,0,08/Mar/2019 22:36:13
3374021,RS Umum St. Elisabeth Semarang,259,63,108,171,0,0,88,0,27/Dec/2018 03:02:04
3374043,RS Umum Telogorejo Semarang,312,120,123,243,0,0,69,0,03/May/2018 01:38:32
3374076,RS Umum Sultan Agung Semarang,395,61,88,149,0,0,246,0,06/Apr/2018 10:33:47
3374112,RS Umum Panti Wilasa Citarum,199,30,46,76,94,112,123,0,19/Apr/2020 22:44:19
3374123,RS Jiwa Daerah  Dr. Amino Gondohutomo,311,126,73,199,0,12,112,0,01/Nov/2018 04:45:26
3374134,RS Umum Daerah Tugurejo Semarang,112,16,30,46,30,36,66,0,17/Jul/2018 07:27:48
3374145,RS Umum Hermina Pandanaran,77,12,39,51,17,9,26,0,14/Apr/2020 07:36:28
3374273,RS Ibu dan Anak Anugerah,20,4,0,4,16,0,16,0,09/Mar/2019 00:07:01
3374342,RS Umum Daerah K.R.M.T Wongsonegoro,547,258,37,295,202,50,252,0,08/Mar/2019 22:31:00
3374353,RS Ibu dan Anak Kusuma Pradja,29,0,2,2,5,27,27,0,23/Feb/2018 11:04:43
3326011,RS Umum Daerah Kraton Kab. Pekalongan,268,100,74,174,42,36,94,2,12/Feb/2019 09:41:35
3375071,RS Umum Karomah Holistic,35,4,0,4,21,29,31,0,19/Apr/2020 22:24:13
3376012,RS Umum Daerah Kardinah,863,174,214,388,0,0,475,0,08/Mar/2019 00:15:46
3376034,RS Umum Tk.IV Tegal,49,154,153,307,154,153,-258,0,16/Jan/2019 07:54:39
3401015,RS Umum Daerah Wates,186,34,35,69,0,0,117,0,19/Apr/2020 19:48:59
3401026,RS Umum St Yusup Boro,38,1,0,1,14,21,37,0,18/Apr/2020 09:22:33
3402016,RS Umum Daerah Panembahan Senopati,204,0,61,61,0,0,143,0,15/Apr/2020 10:16:01
3402020,RS Umum Santa Elisabeth,50,21,15,36,4,10,14,0,09/Mar/2019 12:13:34
3402031,RSU PKU Muhammadiyah Bantul,167,49,35,84,4,9,83,0,08/Apr/2020 15:06:57
3402053,RS Umum Nur Hidayah,98,45,0,45,32,0,53,0,08/Mar/2019 13:59:54
3403010,RS Umum Daerah Wonosari,225,28,38,66,0,0,159,0,16/Apr/2020 12:18:55
3404011,RS Umum Daerah Sleman,180,24,36,60,0,0,120,0,09/Feb/2018 11:39:49
3404022,RS Jiwa Grhasia,470,104,35,139,70,59,331,0,05/Mar/2019 08:01:53
3404033,RS Umum Panti Baktiningsih,46,4,0,4,0,0,42,0,14/Apr/2020 04:17:44
3404070,RSK Bedah An-Nur,34,3,0,3,0,0,31,0,19/Apr/2020 21:59:29
3404102,RS Umum Panti Rini,61,20,18,38,10,16,23,0,27/Feb/2018 08:39:51
3404124,RS Umum Panti Nugroho,6,0,0,0,2,2,6,0,27/Feb/2018 08:47:06
3404146,RS Islam Yayasan PDHI,113,21,22,43,64,64,70,0,16/Apr/2020 17:34:06
3404157,RS Umum Sakina Idaman,155,22,0,22,0,1,133,0,19/Dec/2018 09:56:05
3404015,RSUP Dr. Sardjito,848,152,187,339,16,26,509,479,09/Apr/2020 08:00:03
3471026,RS Islam Hidayatullah Yogyakarta,99,85,0,85,14,0,14,0,20/Jul/2018 14:30:54
3471030,RS Tk. III 04.06.03 Dr. Soetarto,70,5,4,9,25,36,61,0,19/Apr/2020 01:19:52
3471041,RS PKU Muhammadiyah Yogyakarta,183,2,1,3,0,0,180,0,05/Sep/2017 06:04:58
3471052,RS Umum Panti Rapih,399,164,0,164,235,0,235,0,15/Apr/2020 10:00:48
3471063,RS Bethesda Yogyakarta,205,31,21,52,66,69,153,0,17/Apr/2020 08:27:32
3471074,RSPAU Dr.  Suhardi Harjolukito,142,18,28,46,51,45,96,0,15/Apr/2020 10:23:08
3471096,RS  Mata Dr. Yap,36,3,6,9,15,12,27,0,18/Apr/2020 04:27:03
3471234,RS Umum Daerah Kota Yogyakarta,155,45,27,72,27,12,83,0,02/Jan/2019 03:08:14
3471282,RS Ludira Husada Tama,35,23,0,23,9,14,12,0,25/Apr/2019 08:58:39
3471373,RS Happy Land Medical Centre,51,3,3,6,0,0,45,0,19/Apr/2020 22:03:35
3501016,RS Umum Daerah  dr. Darsono,87,37,36,73,0,0,14,0,01/Mar/2018 08:03:34
3502010,RS Umum Daerah Dr. Harjono S. Kabupaten Ponorogo,464,94,87,181,136,124,283,0,02/Feb/2018 01:10:02
3502112,RS Umum Aisyiyah Ponorogo,5,2,1,3,1,1,2,0,29/Aug/2018 08:32:01
3503011,RS Umum Daerah dr. Soedomo Trenggalek,247,0,0,0,0,0,247,0,18/Apr/2020 11:44:52
3504012,RS Umum Daerah Dr. Iskak Tulungagung,464,149,132,281,83,100,183,0,04/Apr/2020 08:19:39
3505013,RS Umum Daerah Ngudi Waluyo Wlingi,302,17,38,55,0,0,247,0,18/Apr/2020 10:42:14
3506014,RS Umum Daerah Kabupaten Kediri,4807,1719,-1816,-97,0,5,4904,1789,01/Mar/2019 08:38:36
3506036,RS Umum Amelia,86,34,43,77,4,5,9,0,08/Mar/2019 11:17:39
3507026,RS Jiwa Dr. Radjiman Wediodiningrat Lawang,725,284,126,410,202,88,315,0,19/Apr/2020 22:50:10
3579030,RS Umum Karsa Husada Kota Batu,126,22,24,46,29,45,80,0,17/Apr/2020 04:08:48
3507052,RS Umum Daerah Kanjuruhan Kepanjen,358,99,107,206,75,77,152,0,08/Apr/2020 08:47:14
3508016,RS Daerah Dr. Haryoto Kabupaten Lumajang,275,0,0,0,0,0,275,0,03/Feb/2018 10:10:26
3509010,RS Umum Daerah Dr. Soebandi,410,150,210,360,0,0,50,0,22/Feb/2019 11:37:31
3509032,RS Tk.III Baladhika Husada Jember,130,18,35,53,34,39,77,0,19/Apr/2020 03:20:02
3509043,RS Paru Jember,112,7,9,16,49,48,96,0,19/Apr/2020 05:51:46
3509123,RS Daerah Kalisat Jember,114,5,21,26,41,47,88,0,16/Apr/2020 01:45:34
3509134,RS Daerah Balung Jember,121,19,57,76,22,16,45,0,08/Mar/2019 05:17:17
3510010,RS Umum Daerah Blambangan,231,27,25,52,36,24,179,0,09/Apr/2020 04:36:30
3510021,RS Umum Bhakti Husada,87,18,16,34,22,31,53,0,19/Apr/2020 01:20:23
3510043,RS Umum Daerah Genteng,120,27,38,65,27,38,55,0,19/Apr/2020 01:21:32
3510054,RS Islam Fatimah,68,4,16,20,0,0,48,0,18/Apr/2020 02:41:28
3510076,RS Yasmin,19,4,6,10,5,5,9,0,26/Oct/2018 12:12:18
3510091,RS Islam Banyuwangi,1,1,1,2,1,1,-1,0,06/Feb/2018 12:26:01
3510102,RS Nahdlatul Ulama Banyuwangi,18,1,1,2,11,17,16,0,12/Jan/2019 07:23:44
3511011,RS Umum dr. H.Koesnadi Bondowoso,342,71,93,164,7,8,178,125,18/Apr/2020 10:08:42
3512012,RS Umum Daerah dr. Abdoer Rahem Kabupaten Situbon,247,49,62,111,74,61,136,0,19/Apr/2020 05:08:15
3513013,RS Umum Daerah Waluyo Jati Kraksaan,238,32,57,89,80,68,149,0,16/Apr/2020 18:00:00
3513024,RS Graha Sehat,103,0,24,24,0,10,79,0,26/Oct/2018 06:25:40
3514036,RS Umum Daerah Bangil,405,90,89,179,3,3,226,0,26/Nov/2018 09:00:24
3515015,RS Umum Daerah Sidoarjo,783,0,0,0,0,0,783,0,12/Feb/2019 05:54:20
3515026,RSU Siti Khodijah Muhammadiyah Cabang Sepanja,44,0,0,0,0,0,44,0,16/Apr/2020 14:41:15
3515106,RS Islam Siti Hajar Sidoarjo,181,0,0,0,0,0,181,0,11/Apr/2020 04:45:30
3516016,RS Umum Sumberglagah Mojokerto,107,19,27,46,28,33,61,0,19/Apr/2020 03:44:14
3516020,RS Umum Daerah Prof. Dr. Soekandar,199,2,2,4,0,0,195,0,18/Apr/2020 10:39:27
3517010,RS Umum Daerah Kab. Jombang,493,89,87,176,0,0,317,0,18/Apr/2020 04:37:10
3518011,RS Umum Daerah Nganjuk,400,149,168,317,122,130,83,0,01/Dec/2018 09:42:26
3518022,RS Umum Daerah Kertosono,245,36,34,70,87,88,175,0,18/Apr/2020 08:45:13
3518033,RS Sumber Waras,14,5,2,7,0,3,7,0,24/Jul/2018 10:49:04
3519012,RS Paru Dungus,51,10,5,15,25,26,36,0,28/Nov/2018 10:57:06
3519023,RS Umum Daerah Caruban,803,125,138,263,0,0,540,0,14/May/2018 17:32:01
3520012,RS Umum Daerah dr. Sayidiman Magetan,825,163,35,198,6,5,627,77,06/Dec/2018 09:00:19
3521013,RS Umum Daerah Dr. Soeroto Ngawi,312,67,64,131,77,102,181,0,17/Apr/2020 07:23:36
3522014,RS Umum Daerah Dr. R. Sosodoro Djatikoesoemo,370,95,60,155,172,181,215,0,17/Apr/2020 03:27:27
3522025,RS Umum Aisyiyah Bojonegoro,173,0,0,0,0,0,173,0,20/Mar/2018 11:20:32
3522047,RS Umum Daerah Sumberrejo,111,19,21,40,31,40,71,0,18/Apr/2020 04:51:58
3522058,RS umum Daerah Padangan,92,21,23,44,19,29,48,0,02/Feb/2018 07:32:52
3523015,RS Umum Daerah Dr. R. Koesma Tuban,466,87,96,183,0,0,283,5,01/Apr/2020 12:12:36
3524016,RS Umum Daerah Dr. Soegiri Lamongan,374,91,105,196,90,95,178,0,11/Apr/2020 04:43:22
3524020,RS Islam Nashrul Ummah,117,12,17,29,33,41,88,0,19/Apr/2020 12:37:56
3524031,RS Umum Muhammadiyah Lamongan,10,1,1,2,2,1,8,0,15/Apr/2020 08:52:27
3525010,RS Umum Daerah Ibnu Sina Kab. Gresik,429,64,67,131,0,0,298,0,17/Jan/2019 11:38:56
3525021,RS Semen Gresik,10,3,2,5,2,3,5,0,06/Mar/2018 10:40:58
3525043,RS Ibu dan Anak Nyai Ageng Pinatih Gresik,39,7,22,29,24,15,10,0,06/Mar/2018 10:21:46
3525076,RS Petrokimia Gresik,104,1,0,1,0,0,103,0,06/Mar/2018 10:21:47
3525087,RS Denisa,53,2,13,15,26,13,38,0,19/Apr/2020 22:53:53
3526011,RS Umum Daerah Syarifah Ambami Rato Ebu,251,56,86,142,57,57,109,0,02/Feb/2018 06:46:35
3527012,RS Umum Daerah Kab. Sampang,489,53,73,126,7,7,363,0,08/Feb/2018 05:52:26
3528013,RS Umum Daerah Dr. H. Slamet Martodirdjo Pamekasan,256,47,61,108,21,40,148,0,17/Jan/2019 01:06:35
3529014,RS Umum Daerah dr. H. Moh. Anwar,200,1,1,2,0,0,198,0,07/Feb/2018 11:41:06
3571016,RS Umum Daerah Gambiran,255,57,58,115,56,81,140,0,17/Apr/2020 02:49:42
3571031,RS Umum Bhayangkara Kediri,289,140,125,265,14,10,24,0,27/Feb/2019 09:59:55
3571053,RS Umum Daha Husada,61,7,1,8,13,14,53,0,23/Feb/2018 11:21:56
3571122,RS Muhammadiyah Ahmad Dahlan,4,3,1,4,0,0,0,0,19/Apr/2020 11:53:07
3572010,RS Umum Daerah Mardi Waluyo,380,73,0,73,223,0,307,0,17/Apr/2020 20:25:11
3505054,RS Umum An-Nisaa,57,16,15,31,22,22,26,0,11/Apr/2020 04:40:32
3573011,RS Umum Daerah Dr. Saiful Anwar,932,262,269,531,190,227,401,0,13/Apr/2020 08:45:13
3573055,RS Umum Panti Waluya Sawahan Malang,192,28,25,53,127,139,139,0,19/Apr/2020 03:50:26
3573066,RS Umum Lavalette Malang,3,0,0,0,3,3,3,0,31/Jan/2018 11:38:06
3507070,RS Marsudi Waluyo,6,0,0,0,0,0,6,0,17/Apr/2020 11:40:55
3573135,RS Ibu dan Anak Muhammadiyah Malang,53,18,18,36,35,35,17,0,19/Apr/2020 22:01:01
3507204,RS Umum Islam Gondang Legi,97,15,16,31,33,36,66,0,18/Apr/2020 01:52:20
3573226,RS Islam Malang,8,0,0,0,0,0,8,0,18/Apr/2020 14:12:15
3574012,RS Umum Daerah dr. Mohamad Saleh Kota Probolinggo,216,48,41,89,53,79,127,0,05/Feb/2018 08:42:14
3513067,RS Umum Daerah Tongas,154,14,25,39,58,57,115,0,10/Apr/2020 10:15:40
3575013,RS Umum Daerah Dr. R. Soedarsono Kota Pasuruan,281,36,36,72,83,126,209,0,16/Apr/2020 10:45:47
3576014,RS Umum Dr. Wahidin Sudiro Husodo Kota Mojokerto,164,37,42,79,39,27,85,0,02/Feb/2018 01:00:18
3516073,RS Umum Daerah Raden Achmad Basoeni,93,0,0,0,0,0,93,0,23/Feb/2018 10:17:30
3577015,RS Umum Daerah Dr. Soedono Madiun,402,0,8,8,0,0,394,0,01/Feb/2018 05:53:12
3577074,RS Umum Islam Siti Aisyah,144,0,0,0,0,0,144,0,31/Dec/2018 10:33:01
3577085,RS Umum Daerah Kota Madiun,214,0,0,0,0,0,214,0,23/Nov/2018 04:07:37
3578016,RS Umum Daerah Dr. Soetomo,1141,212,210,422,0,0,719,0,17/Apr/2020 02:15:21
3578086,RS Primasatya Husada Citra (PHC) Surabaya,41,0,0,0,0,0,41,0,16/Apr/2020 10:40:23
3578122,RS Umum Tk. III Brawijaya,112,36,30,66,18,28,46,0,10/May/2018 07:07:43
3578192,RS Jiwa Menur,286,187,99,286,0,0,0,0,17/Apr/2020 03:00:01
3578443,RS Umum Siloam Hospitals Surabaya,160,54,34,88,0,0,72,0,15/Apr/2020 12:20:42
3578523,RS Umum Haji Surabaya,280,79,70,149,53,77,131,0,17/Apr/2020 03:46:32
3578560,RS Husada Utama Surabaya,10,0,0,0,0,0,10,0,16/Apr/2020 14:11:16
3578571,RS Umum Daerah dr. Mohamad Soewandhie,268,94,128,222,24,22,46,0,19/Apr/2020 08:59:34
3578764,RS Bhayangkara TK II HS. Samsoeri Mertojoso,283,21,27,48,219,16,235,0,16/Apr/2020 07:40:25
3602011,RS Umum Daerah Dr. Adjidarmo,363,0,0,0,0,0,363,0,22/Nov/2018 09:16:22
3602022,RS Misi Lebak,155,26,24,50,46,59,105,105,28/Mar/2020 11:22:23
3674056,RS Islam Asshobirin,5,1,1,2,4,4,3,0,17/Nov/2017 07:54:39
3671126,RS Umum Aminah,47,19,14,33,3,8,14,0,09/Apr/2020 06:16:50
3604013,RS Umum Daerah dr. Drajat Prawiranegara,494,140,154,294,89,98,200,0,17/Apr/2020 07:29:06
3603010,RS Umum Daerah Kabupaten Tangerang,566,156,247,403,15,42,163,0,04/Jul/2017 14:48:09
3671021,RS Daan Mogot,25,3,1,4,11,11,21,0,17/Apr/2020 10:25:54
3671032,RSUP Dr. Sitanala Tangerang,958,72,115,187,630,642,771,0,04/Jul/2017 14:48:09
3671043,RS Sari Asih Karawaci,139,37,56,93,18,28,46,0,18/Apr/2020 09:14:58
3671076,RS An-Nisa,147,52,31,83,33,31,64,0,17/Apr/2020 07:26:15
3671146,RS Umum Bhakti Asih,137,26,35,61,34,42,76,0,18/Apr/2020 09:56:40
3672022,RS Umum Daerah Kota Cilegon,230,49,35,84,72,75,146,0,17/Apr/2020 04:57:42
3672034,RS Kurnia,9,1,1,2,3,3,7,0,16/Apr/2020 06:17:42
5101016,RS Umum Daerah Negara,165,40,34,74,41,50,91,0,19/Apr/2020 01:48:23
5102010,RS Umum Daerah Tabanan,239,125,102,227,12,7,12,0,02/Feb/2019 06:41:55
5102021,RS Umum Dharma Kerti,32,12,10,22,10,10,10,0,13/Apr/2020 03:21:19
5104012,RS Umum Daerah Sanjiwani Gianyar,2555,90,79,169,1185,1198,2386,0,02/Apr/2020 08:15:01
5105013,RS Umum Daerah Klungkung,169,82,0,82,87,0,87,0,13/Jul/2017 08:49:43
5106025,RS Jiwa Provinsi Bali,390,182,88,270,68,51,120,0,26/Feb/2018 07:29:48
5107015,RS Umum Daerah Karangasem,255,43,54,97,0,0,158,0,05/Mar/2019 05:31:12
5108016,RS Umum Daerah Kab. Buleleng,336,310,0,310,26,0,26,0,04/Mar/2019 02:59:51
5171016,RSUP Sanglah,777,200,195,395,0,0,382,0,08/Mar/2019 06:29:58
5171020,RS Umum Daerah Wangaya,186,61,56,117,145,159,69,0,04/Dec/2018 06:14:30
5171064,RS Khusus Mata Bali Mandara,30,4,6,10,20,20,20,0,01/Mar/2019 09:37:54
5201010,RS Umum Daerah Patut Patuh Patju,136,41,55,96,21,14,40,0,06/Apr/2020 08:05:44
5202011,RS Umum Praya,236,94,92,186,134,134,50,0,16/Apr/2020 11:25:40
5203012,RS Umum Daerah Dr. R. Soedjono Selong,379,241,240,481,153,153,-102,0,01/Apr/2020 11:01:01
5204013,RS Umum Sumbawa Besar,139,6,6,12,5,5,127,0,11/Apr/2020 10:31:29
5205014,RS Umum Dompu,174,40,61,101,38,54,73,0,07/Feb/2018 06:21:13
5206015,RS Umum Bima,143,39,77,116,15,12,27,0,14/Mar/2018 05:31:01
5271010,RS Umum Daerah NTB,375,0,0,0,0,0,375,0,07/Feb/2018 05:00:26
5271054,RS Jiwa Mutiara Sukma,150,57,37,94,85,59,56,0,20/Mar/2020 07:25:08
5271076,RS Risa Sentra Medika,56,7,9,16,0,0,40,0,15/Apr/2020 08:26:41
5301011,RS Kristen Lende Moripa,167,22,24,46,60,61,121,0,12/Apr/2020 11:07:24
5301033,RS Umum Waikabubak,125,39,57,96,0,0,29,0,05/Mar/2019 04:06:10
5302023,RS Umum Daerah Waingapu,130,26,45,71,0,0,59,0,02/Mar/2018 07:42:10
5302034,RS Umum Imanuel Sumba,50,1,1,2,21,27,48,0,17/Apr/2020 02:39:33
5304014,RS Umum Soe,106,47,49,96,47,49,10,0,05/Nov/2018 08:52:00
5305015,RS Umum Daerah Kefamenanu,111,19,18,37,36,39,74,0,19/Apr/2020 02:25:17
5306016,RS Umum Daerah MGR Gabriel Manek,185,28,42,70,35,83,115,0,15/Apr/2020 03:33:22
5306031,RS Sito Husada,31,4,2,6,4,3,25,0,18/Apr/2020 10:45:22
5306042,RS Umum Penyangga Perbatasan Betun,94,13,11,24,25,45,70,0,23/Jul/2018 07:06:11
5307010,RS Umum Daerah Kalabahi,124,32,47,79,20,24,45,0,15/Feb/2018 06:26:24
5307021,RS Bergerak Kab.Alor,13,0,2,2,3,5,11,0,23/Feb/2018 08:20:56
5308045,RS Umum Daerah Lewoleba,171,9,9,18,8,7,153,0,12/Feb/2018 05:22:51
5310012,RS Umum Dr TC Hillers Maumere,204,39,55,94,49,62,110,0,16/Apr/2020 08:01:41
5311013,RS Umum Daerah Ende,215,49,84,133,19,16,82,0,07/Feb/2018 10:33:53
5312014,RS Umum Bajawa,99,30,47,77,13,16,22,0,06/Mar/2019 04:13:14
5313015,RS Umum Daerah dr. Ben Mboi Ruteng,203,40,67,107,32,60,96,0,19/Apr/2020 05:17:41
5371011,RS Umum Prof Dr WZ Johanes,358,126,166,292,19,41,66,0,19/Feb/2019 04:25:07
5303022,RS Tk.IV Wirasakti Kupang,100,0,0,0,0,0,100,0,21/Dec/2018 12:21:08
5303033,RS Bhayangkara,100,0,0,0,73,77,100,0,10/Apr/2020 03:43:43
6172011,RS Umum Daerah Dr. Abdul Aziz Singkawang,285,68,87,155,54,80,130,0,01/Oct/2018 03:46:17
6101022,RS Umum Daerah Sambas,132,16,18,34,0,0,98,0,19/Apr/2020 22:25:02
6101033,RS Umum Daerah Pemangkat,140,31,14,45,74,21,95,0,19/Apr/2020 23:00:53
6172066,RS Jiwa Provinsi Kalimantan Barat,412,0,0,0,0,0,412,0,14/Feb/2018 06:58:11
6102012,RS Umum Daerah Bengkayang,117,8,20,28,35,54,89,0,18/Apr/2020 06:49:51
6103013,RS Umum Daerah Kabupaten Landak,124,21,13,34,68,22,90,0,19/Apr/2020 22:56:53
6104014,RS Umum Daerah Dr. Rubini Mempawah,167,46,45,91,114,114,76,0,17/Apr/2020 12:01:01
6105015,RS Umum Daerah M. Th. Djaman Sanggau,129,20,27,47,37,42,82,0,17/Apr/2020 04:00:37
6106016,RS Umum Daerah Dr. Agoesdjam Ketapang,130,50,51,101,12,11,29,0,13/Apr/2020 08:09:06
6106020,RS Fatima Ketapang,220,46,72,118,46,56,102,102,23/Mar/2020 10:57:43
6107010,RS Umum Daerah Ade Muhammad Djoen Sintang,136,25,36,61,37,38,75,0,18/Apr/2020 09:15:34
6108011,RS Umum Daerah dr. A. Diponegoro Putussibau,135,36,37,73,13,41,62,0,19/Feb/2019 06:12:37
6109012,RS Umum Daerah Kabupaten Sekadau,91,7,8,15,11,53,76,0,14/Apr/2020 05:23:03
6110012,RS Umum Daerah Kabupaten Melawi,84,13,10,23,40,55,61,0,01/Nov/2017 07:03:19
6171011,RS Umum Daerah Dr. Soedarso Pontianak,470,136,117,253,89,116,217,0,06/Mar/2019 04:34:37
6171022,RS Tk.II Kartika Husada Kes.Dam XII Tanjungpura,13,3,1,4,5,4,9,0,18/Apr/2020 03:04:07
6171044,RS Jiwa Daerah Sei Bangkong Pontianak,109,40,7,47,51,11,62,0,15/Apr/2020 04:32:19
6171113,RS Islam Yarsi Pontianak,89,32,30,62,12,15,27,0,18/Mar/2018 03:33:18
6201012,RS Umum Daerah Sultan Imanuddin,252,60,54,114,0,0,138,0,17/Apr/2020 04:11:07
6202013,RS Umum Daerah Dr Murjani Sampit,263,58,69,127,1,1,136,0,13/Feb/2018 09:32:14
6209024,RS Umum Daerah  Mas Amsyar Kasongan,100,28,31,59,23,25,41,0,28/Feb/2018 09:17:55
6203015,RS Umum Daerah Dr H Soemarno S,169,41,45,86,111,111,83,0,19/Apr/2020 10:55:45
6211026,RS Umum Daerah Kuala Kurun,57,11,12,23,13,21,34,0,15/Apr/2020 09:38:06
6204016,RS Umum Daerah Jaraga Sasameh,143,34,55,89,0,0,54,0,19/Apr/2020 18:30:00
6212020,RS Umum Daerah Tamiang Layang,97,14,24,38,28,31,59,0,19/Apr/2020 10:16:49
6205011,RS Umum Daerah Muara Teweh,119,43,59,102,5,3,17,0,16/Apr/2020 11:22:55
6213022,RS Umum Daerah Puruk Cahu,31,15,13,28,16,16,3,0,19/Apr/2020 22:01:01
6207033,RS Umum Daerah Sukamara,78,7,10,17,27,34,61,0,01/Nov/2018 05:55:36
6207012,RS Umum Daerah Kabupaten Lamandau,62,3,1,4,4,9,58,0,26/Nov/2018 07:00:16
6208014,RS Umum Daerah Kuala Pembuang,69,0,1,1,13,22,68,0,26/Nov/2018 08:19:36
6210015,RS Umum Daerah Pulang Pisau,76,30,13,43,21,12,33,0,04/Mar/2019 05:34:50
6271012,RS Umum Daerah Dr Doris Sylvanus Palangka Raya,411,139,113,252,57,103,159,0,19/Apr/2020 09:28:47
6301013,RS Umum Daerah H. Boejasin Pelaihari,165,56,70,126,17,27,39,0,18/Apr/2020 04:33:11
6302014,RS Umum Daerah Kabupaten Kotabaru,112,25,25,50,25,39,62,0,29/Mar/2020 01:57:53
6303015,RS Umum Daerah Ratu Zalecha,258,72,25,97,148,38,161,0,19/Apr/2020 16:16:01
6303026,RS Umum Danau Salak,47,8,5,13,8,28,34,0,07/Jan/2019 12:02:07
6304016,RS Jiwa Sambang Lihum,300,130,33,163,117,22,137,0,07/Apr/2020 03:42:57
6304020,RS Umum Daerah  H. Abdul Aziz Marabahan,32,6,7,13,12,9,19,0,19/Feb/2019 06:48:55
6305010,RS Umum Daerah Datu Sanggul Rantau,133,20,16,36,45,52,97,0,04/Apr/2020 05:09:03
6306011,RS Umum Daerah Brigjed H. Hasan Basry Kandangan,615,185,42,227,227,226,388,0,08/Mar/2019 22:56:18
6307012,RS Umum Daerah  H Damanhuri Barabai,348,4585,6072,10657,0,0,-10309,0,13/Feb/2019 05:37:05
6308013,RS Umum Daerah Pambalah Batung,256,52,58,110,12,11,146,0,02/Oct/2017 06:02:26
6309014,RS Umum Daerah H. Badaruddin Kasim,798,238,261,499,17,47,299,499,04/Jul/2017 14:48:09
6310015,RS Umum Daerah dr. H. Andi Abdurrahman Noor,140,93,93,186,12,21,-46,0,15/Apr/2020 08:45:11
6371013,RS Umum Daerah Ulin Banjarmasin,590,190,216,406,61,74,184,0,17/Apr/2020 03:53:21
6371046,RS Islam Banjarmasin,4,0,0,0,0,0,4,0,16/Apr/2020 12:44:34
6371072,RS Umum Daerah Dr. H. Moch. Ansari Saleh,1623,595,598,1193,186,231,430,0,07/Jan/2019 05:07:54
6371141,RS TNI-AU Tk.IV Syamsudin Noor,38,0,0,0,22,21,38,0,26/Mar/2020 09:06:26
6372014,RS Umum Daerah Idaman Banjarbaru,223,96,94,190,0,0,33,0,15/Jan/2019 04:55:13
6401014,RS Umum Daerah Panglima Sebaya,187,31,64,95,46,45,92,0,17/Apr/2020 03:34:02
6403015,RS Umum Daerah Aji Muhammad Parikesit,264,78,94,172,0,0,92,0,19/Apr/2020 04:11:23
6402041,RS Umum Daerah Harapan Insan Sendawar,205,31,24,55,0,0,150,0,06/Mar/2019 09:23:11
6403052,RS Umum Daerah Aji Batara Agung Dewa Sakti,98,19,18,37,25,36,61,0,07/Apr/2020 08:09:45
6404021,RS Umum Daerah Tanjung Selor,165,62,88,150,1,1,15,0,06/Mar/2018 11:48:18
6404032,RS Umum Daerah Kudungga,108,7,6,13,0,11,95,0,16/Apr/2020 05:01:20
6405011,RS Umum Daerah Dr. Abdul Rivai,182,85,81,166,7,8,16,0,04/Mar/2019 04:06:53
6408025,RS Umum Daerah Kabupaten Nunukan,165,33,29,62,45,58,103,0,19/Apr/2020 06:41:22
6409036,RS Umum Daerah Ratu Aji Putri Botung,90,19,18,37,17,26,53,0,05/Mar/2019 03:27:07
6471014,RS Umum Daerah Dr. Kanujoso Djatiwibowo,448,96,93,189,0,0,259,0,17/Apr/2020 03:32:20
6471036,RS Tk.II Dr R Hardjanto,194,129,129,258,0,0,-64,0,07/Apr/2020 07:33:35
6471051,RS  Restu Ibu,163,20,43,63,33,55,100,0,25/Dec/2018 05:02:06
6471062,RS Ibu dan Anak Sayang Ibu,24,0,10,10,0,14,14,0,06/Apr/2020 02:55:09
6472015,RS Umum Daerah Abdul Wahab Sjahranie,713,134,100,234,207,272,479,0,13/Apr/2020 02:53:31
6472041,RS Umum Tk. IV Samarinda,61,0,0,0,0,0,61,0,13/Apr/2020 02:18:04
6472063,RS Jiwa Atma Husada Mahakam,183,87,31,118,53,13,65,0,18/Apr/2020 21:00:02
6472118,RS Umum Daerah Inche Abdoel Moeis,143,52,51,103,19,18,40,0,15/Oct/2018 07:49:59
6473016,RS Umum Daerah Tarakan,369,78,74,152,0,0,217,0,01/Mar/2019 04:09:50
6474032,RS Umum Daerah Taman Husada,176,24,11,35,127,14,141,0,09/Apr/2020 07:15:44
7101013,RS Umum Datoe Binangkang,132,9,7,16,29,25,116,0,12/Feb/2018 12:51:11
7102014,RS Umum Dr.Sam Ratulangi,11,4,4,8,2,3,3,0,28/Feb/2018 07:12:07
7102120,RS Umum Noongan,90,40,50,90,13,20,0,0,27/Feb/2018 08:31:33
7103015,RS Umum Liun Kendage,86,28,28,56,28,31,30,0,28/Feb/2018 01:51:36
7103026,RS Bergerak Kab.Kep.Sitaro,66,9,27,36,23,25,30,0,28/Feb/2018 01:33:11
7104027,RS Bergerak Kab.Kep.Talaud,56,65,76,141,24,27,-85,0,06/Mar/2018 10:17:07
7171013,RSUP Prof. Dr. R. D. Kandou,1987,315,288,603,708,676,1384,0,17/Apr/2020 03:26:46
7171024,RS TK. II R. W. Mongisidi,202,64,81,145,28,29,57,0,08/Mar/2019 03:06:04
7171035,RS Jiwa Prof. Dr. V. L. Ratumbusyang,180,100,50,150,-10,40,30,0,27/Mar/2020 04:50:56
7172036,RS Umum Daerah Bitung,234,27,26,53,70,111,181,0,19/Apr/2020 02:21:16
7202015,RS Umum Daerah Kabupaten Banggai,313,44,44,88,65,105,225,0,17/Apr/2020 04:28:47
7203016,RS Umum Daerah Morowali,175,16,13,29,117,29,146,0,20/Apr/2020 00:00:39
7204010,RS Umum Daerah Poso,225,32,44,76,66,83,149,0,14/Apr/2020 05:50:58
7204021,RS Umum Daerah Kolonedale,100,40,39,79,2,6,21,0,17/Apr/2020 10:36:18
7209032,RS Umum Daerah Ampana,191,16,31,47,61,80,144,0,18/Apr/2020 03:46:15
7208011,RS Umum Daerah Anuntaloko Parigi,230,27,35,62,57,80,168,0,11/Apr/2020 08:19:28
7205022,RS Umum Daerah Kabelota,105,17,22,39,32,34,66,0,03/Dec/2018 07:30:09
7206012,RS Umum  Mokopido Toli-Toli,274,42,37,79,96,100,195,0,06/Apr/2020 08:06:42
7207013,RS Umum Daerah Buol,30,0,0,0,0,0,30,0,09/Feb/2018 06:58:50
7271014,RS Umum Daerah Undata Palu,590,606,589,1195,251,40,-605,0,15/Apr/2020 06:53:54
7271025,RS TK.IV Wirabuana Palu,86,18,18,36,33,21,50,0,19/Apr/2020 10:05:02
7271036,RS Umum Anutapura Palu,437,125,110,235,183,21,202,0,14/Apr/2020 11:36:49
7271051,RS Umum Daerah Madani Palu,224,50,26,76,38,59,148,0,09/Feb/2018 07:36:44
7271095,RS Budi Agung Palu,95,0,0,0,0,0,95,0,03/Dec/2018 07:23:16
7301015,RS Umum Daerah K.H. Hayyung Kepulauan Selayar,154,22,18,40,0,9,114,0,11/Apr/2020 03:04:04
7302016,RS Umum Daerah H.A. Sulthan Daeng Radja,366,67,65,132,94,146,234,0,05/Feb/2019 04:10:26
7303010,RS Umum Daerah Prof.Dr.H.M. Anwar Makkatutu,159,68,67,135,18,27,24,1,08/Mar/2019 04:18:01
7304011,RS Umum Daerah Lanto Daeng Pasewang,217,29,51,80,57,64,137,0,11/Apr/2020 05:12:20
7305012,RS Umum Daerah H. Padjonga Dg. Ngalle Takalar,293,18,22,40,21,40,253,0,19/Apr/2020 02:47:39
7306046,RS Umum Daerah Syehk Yusuf Gowa,164,32,55,87,31,46,77,0,17/Apr/2020 01:12:43
7307014,RS Umum Daerah Kabupaten Sinjai,140,0,0,0,0,0,140,2,02/Apr/2020 04:30:04
7308026,RS Tk.IV DR. M. Yasin Bone,120,40,58,98,11,11,22,0,02/Mar/2019 09:54:39
7308041,RS Umum Daerah Tenriawaru Bone,290,56,92,148,0,0,142,0,16/Apr/2020 05:34:38
7309016,RS Umum Daerah Salewangang Maros,181,11,7,18,69,94,163,0,10/Apr/2020 01:36:38
7310016,RS Umum Batara Siang,150,41,59,100,3,4,50,0,18/Apr/2020 07:21:20
7311010,RS Umum Daerah Barru,177,2,0,2,0,0,175,0,14/Apr/2020 07:52:40
7312011,RS Umum Daerah Latemmamala Soppeng,258,82,104,186,45,37,72,0,12/Feb/2018 08:54:46
7313012,RS Umum Daerah Lamaddukkelleng Kabupaten Wajo,161,0,0,0,0,0,161,0,14/Apr/2020 05:00:48
7314013,RS Umum Daerah Nene Mallomo,156,40,40,80,34,42,76,0,19/Apr/2020 01:35:51
7314024,RS Umum Daerah Arifin Numang,131,10,15,25,0,0,106,0,16/Apr/2020 05:46:08
7315014,RS Umum Daerah Lasinrang Pinrang,184,14,21,35,0,0,149,0,18/Apr/2020 11:01:24
7316015,RS Umum Daerah Massenrempulu Enrekang,117,13,35,48,0,0,69,0,17/Apr/2020 03:34:43
7373016,RS Umum Daerah Sawerigading,442,178,96,274,134,37,168,0,10/Apr/2018 09:53:20
7317053,RS Umum Daerah Andi Djemma Masamba,197,30,48,78,52,69,119,0,17/Apr/2020 08:30:05
7318054,RS Umum Daerah Lakipadada,204,17,26,43,0,0,161,0,16/Apr/2020 04:48:11
7325016,RS Umum Daerah I Lagaligo,200,14,49,63,56,73,137,0,17/Apr/2020 04:24:58
7371026,RS Umum Daerah Labuang Baji,141,26,35,61,20,27,80,0,18/Sep/2018 11:13:01
7371030,RS Tk.II Pelamonia,236,63,63,126,173,173,110,0,16/Apr/2020 20:01:01
7371041,RS Kepolisian Bhayangkara,323,0,0,0,0,0,323,0,18/Apr/2020 11:24:03
7371063,RS Stella Maris,288,26,22,48,0,0,240,0,19/Apr/2020 05:15:03
7371074,RS AL Jala Ammari Makassar,4,0,0,0,0,0,4,0,18/Apr/2020 10:29:57
7371176,RS Bersalin Elim Makassar,2,0,0,0,0,1,2,0,20/Dec/2018 12:50:04
7371191,RS Ibu dan Anak Sitti Khadijah 1 Muhammadiyah,110,0,20,20,0,16,90,0,08/Feb/2019 09:38:26
7371256,RS Khusus Daerah Ibu dan Anak Siti Fatimah,37,10,8,18,5,14,19,0,10/Aug/2018 10:11:13
7371314,RS Dr. Tadjuddin Chalid MPH,129,31,28,59,24,37,70,0,06/Mar/2019 04:59:03
7371325,RSUP Dr. Wahidin Sudirohusodo,1087,158,111,269,679,108,818,0,09/Apr/2018 07:52:43
7371340,RS Ibnu Sina Makassar,240,25,46,71,0,0,169,0,18/Apr/2020 04:18:02
7371362,RS Umum Daerah Haji Makassar,210,0,0,0,0,0,210,0,22/Feb/2018 06:30:23
7371373,RS Grestelina,213,20,25,45,51,70,168,0,11/Apr/2020 06:02:47
7371395,RS Umum Daerah Daya Kota Makassar,162,17,59,76,24,62,86,0,15/Apr/2020 02:45:07
7372020,RS Fatima Pare-Pare,2,0,0,0,0,0,2,0,18/Apr/2020 09:06:01
7372075,RS Umum Daerah Andi Makkasau Parepare,274,81,94,175,0,0,99,0,06/Mar/2019 04:50:21
7472016,RS Umum Daerah Kota Bau Bau,151,18,18,36,0,0,115,0,14/Apr/2020 03:12:57
7401038,RS Umum Daerah Kabupaten Buton,67,0,0,0,0,0,67,0,22/Feb/2018 01:46:38
7402010,RS Umum Daerah Raha,146,63,75,138,4,4,8,0,20/Feb/2019 02:24:48
7471011,RS Bahteramas Provinsi Sultra,404,33,35,68,129,131,336,0,14/Apr/2020 04:27:59
7403022,RS Umum Daerah Konawe,908,248,299,547,35,80,361,519,04/Jul/2017 14:48:09
7403033,RS Tk.IV Dr. R Ismoyo Kendari,56,1,7,8,21,27,48,0,17/Apr/2020 10:16:07
7471044,RS Santa Anna,10,0,2,2,8,8,8,0,15/Apr/2020 04:02:35
7471066,RS  Jiwa Kendari,205,129,69,198,4,3,7,0,19/Feb/2018 04:33:29
7471092,RS Umum Daerah Kota Kendari,129,1,0,1,2,3,128,0,01/Mar/2019 05:48:03
7403114,RS Umum Daerah Konawe Selatan,106,6,7,13,38,54,93,0,17/Apr/2020 03:53:56
7404012,RS Benyamin Guluh Kolaka,172,37,33,70,40,52,102,0,02/Mar/2019 03:14:11
7404023,RS  Antam Nikel Pomalaa,50,3,4,7,2,2,43,0,21/Feb/2019 05:00:58
7404034,RS Umum Daerah H.M.Djafar Harun,113,41,53,94,34,45,19,0,25/Feb/2019 04:51:07
7502033,RS Umum Daerah dr. M. Mohammad Dunda,195,42,100,142,38,15,53,1,09/Mar/2018 09:10:30
7504032,RS Umum Daerah Toto Kabila,222,27,31,58,0,0,164,0,13/Apr/2020 03:56:49
7501043,RS Umum Daerah Tani dan Nelayan,150,13,14,27,51,71,123,0,19/Apr/2020 02:24:30
7503045,RS Umum Daerah Bumi Panua,123,31,57,88,16,19,35,0,19/Dec/2018 05:01:48
7571010,RS Umum Daerah Prof Dr. H. Aloei Saboe,400,76,64,140,102,158,260,0,19/Apr/2020 10:49:48
7601011,RS Umum Daerah Kabupaten Majene,143,33,33,66,39,61,77,0,17/Apr/2020 03:28:00
7602044,RS Umum Daerah Polewali,310,46,88,134,77,92,176,0,18/Apr/2020 03:12:04
7604012,RS Umum Daerah Kabupaten Mamuju,108,5,17,22,37,49,86,0,11/Apr/2020 06:47:37
8101015,RS Umum Karel Sadsuitubun,135,11,28,39,44,52,96,0,17/Apr/2020 04:09:39
8103016,RS Umum Saparua,37,5,3,8,14,15,29,0,23/Feb/2018 11:25:21
8103020,RSUD Kab. Buru,55,16,15,31,9,15,24,0,08/Feb/2018 09:11:14
8103042,RS Umum Masohi,267,108,169,277,108,169,-10,0,31/Jan/2018 08:58:54
8103053,RS Umum Daerah dr. Ishak Umarella,115,5,15,20,24,46,95,0,06/Feb/2018 08:25:17
8105019,RS Umum Daerah Cendrawasih Dobo,78,5,1,6,3,4,72,0,19/Feb/2018 02:27:05
8107021,RS Umum Daerah Bula,93,9,19,28,31,32,65,0,09/Nov/2018 05:39:54
8171015,RS Umum Dr. M. Haulussy Ambon,402,57,91,148,90,143,254,0,06/Apr/2020 05:29:13
8171026,RS Tk. II Prof. dr. J. A. Latumeten,14,0,0,0,0,0,14,0,19/Apr/2020 04:47:32
8171063,RSKD Provinsi Maluku,110,28,22,50,36,24,60,0,09/Feb/2018 06:50:14
8171085,RS Sumber Hidup GPM,60,6,14,20,14,22,40,0,16/Apr/2020 03:15:52
8201010,RS Umum Daerah Tobelo,140,35,40,75,27,32,65,0,01/Mar/2019 04:53:01
8201021,RS Umum Daerah Jailolo,78,14,30,44,0,0,34,0,27/Feb/2018 04:43:36
8202043,RS Umum Daerah Kota Tidore Kepulauan,145,21,25,46,0,9,99,0,30/Aug/2018 06:08:33
8203020,RS Umum Daerah Sanana,78,11,11,22,6,15,56,0,28/Feb/2018 09:39:44
8204010,RS Umum Daerah  Labuha,16,10,0,10,0,6,6,0,28/Feb/2018 07:36:17
8206012,RS Umum Daerah Maba,73,21,52,73,0,6,0,0,25/Feb/2018 05:44:56
8271016,RS Umum Daerah Dr. H. Chasan Boesoirie Ternate,258,45,31,76,62,118,182,0,14/Apr/2020 05:50:09
9101010,RS Umum Daerah Fakfak,116,15,22,37,34,42,79,0,17/Apr/2020 06:57:14
9102033,RS AL dr. Azhar Zahir Manokwari,34,0,0,0,0,0,34,0,08/Dec/2018 04:31:42
9171010,RS Umum Daerah Kabupaten Sorong,189,39,88,127,13,39,62,0,14/Feb/2019 04:16:56
9171032,RS Umum Daerah Sele Be Solu,152,32,31,63,40,49,89,0,16/Apr/2020 01:54:37
9201012,RS Umum Merauke,356,66,83,149,74,92,207,0,02/May/2018 09:59:10
9202012,RS Umum Nabire,212,3,2,5,7,8,207,0,06/Dec/2018 07:51:27
9202013,RS Umum Wamena,171,83,81,164,81,79,7,0,17/Jan/2019 01:38:01
9202023,RS Umum Daerah Paniai,110,20,16,36,29,55,74,0,09/Apr/2018 06:11:38
9204014,RS Umum Daerah Serui,124,35,39,74,20,30,50,0,18/Feb/2019 04:43:20
9205015,RS Umum Biak,215,0,0,0,0,0,215,0,14/Feb/2018 08:38:49
9212011,RS Umum Daerah Kabupaten Mimika,163,41,50,91,26,28,72,0,13/Feb/2018 09:49:55
1905026,RS Pratama Kriopanting Payung,18,1,2,3,6,9,15,0,16/Apr/2020 09:17:16
9220043,RS Umum Daerah Kwaingga Kabupaten Keerom,87,2,4,6,31,50,81,0,19/Apr/2020 06:54:11
9271012,RS Umum Jayapura,360,91,83,174,0,0,186,0,19/Feb/2018 09:14:52
9271023,RS Umum Abepura,153,30,43,73,32,37,80,0,15/Apr/2020 09:57:24
9271034,RS TK IV dr.Aryoko,26,2,3,5,11,10,21,0,17/Apr/2020 02:25:27
9271045,RS Jiwa Abepura,0,0,0,0,0,0,0,0,14/Feb/2018 09:29:54
9271056,RS Dian Harapan,71,7,19,26,0,10,45,0,16/Apr/2020 05:33:48
9271067,RS Bhayangkara Jayapura,157,34,32,66,4,2,91,0,12/Apr/2020 04:40:59
3402075,RS Umum Permata Husada,15,0,0,0,7,7,15,0,15/Feb/2018 10:56:24
9214012,RS Umum Daerah Kabupaten Mappi,77,9,14,23,26,28,54,0,07/Jun/2018 07:26:05
3212053,RS Umum Permata Medical Center,56,0,0,0,0,0,56,0,24/Apr/2018 11:57:57
1277026,RS Umum Inanta,0,0,0,0,0,0,0,0,24/May/2018 11:39:39
7408013,RS Umum Daerah Kab.Konawe Utara,24,6,5,11,6,7,13,0,22/Feb/2018 06:34:24
7502032,RS Umum Daerah Otanaha,86,15,20,35,16,35,51,0,27/Feb/2018 08:10:00
1471091,RS Umum Daerah  Petala Bumi,61,14,26,40,8,13,21,0,13/Apr/2020 04:21:37
5104023,RS Umum Premagana,54,6,26,32,11,9,22,0,18/Apr/2020 03:43:09
7201011,RS Umum Daerah Banggai,99,10,5,15,8,5,84,0,03/Dec/2018 07:38:56
7271127,RS Bhayangkara Palu,90,0,0,0,0,0,90,0,03/Dec/2018 07:33:59
1709038,RS Umum Daerah Bengkulu Tengah,70,4,3,7,28,35,63,0,18/Apr/2020 12:51:29
1805034,RS Umum Daerah Demang Sepulau Raya,134,8,18,26,50,58,108,0,19/Apr/2020 05:43:50
3302121,RS Ibu dan Anak Amanah,21,9,12,21,4,0,0,0,19/Apr/2020 23:04:53
3305114,RS Umum Purwogondo,84,11,29,40,22,31,44,0,13/Apr/2020 06:48:19
3311027,RS Khusus Bedah Karima Utama,100,29,19,48,0,0,52,0,15/Apr/2020 08:05:23
3313042,RS Ibu dan Anak Dian Pertiwi,31,0,5,5,0,26,26,0,19/Feb/2019 05:04:42
3318108,RS Umum Keluarga Sehat,228,46,54,100,60,63,128,0,19/Apr/2020 03:44:41
3328011,RS Umum Daerah dr. Soeselo Slawi Kabupaten Tegal,367,73,95,168,83,116,199,0,18/Apr/2020 06:05:47
3401048,RS Umum Kharisma Paramedika,52,9,8,17,35,35,35,0,18/Apr/2020 22:00:53
3402064,RS Umum Rachma Husada,49,12,9,21,13,16,28,0,16/Apr/2020 08:08:04
3402086,RS Rajawali Citra,54,8,7,15,2,1,39,0,18/Apr/2020 08:46:40
3404045,RS Umum Queen Latifa,20,7,6,13,7,7,7,0,27/Feb/2018 08:27:45
3404081,RS Umum Condong Catur,44,8,0,8,0,0,36,0,19/Apr/2020 21:53:31
3404092,RSU Puri Husada Yogyakarta,1,1,1,2,0,0,-1,0,15/Apr/2020 13:10:02
3404168,RS Umum Daerah Prambanan,131,42,0,42,73,4,89,0,02/Jun/2018 11:02:04
3507085,RS Umum Daerah Lawang,138,36,35,71,25,42,67,0,01/Feb/2018 09:59:52
3515121,RS Umum Anwar Medika,895,243,283,526,17,47,369,519,16/Apr/2020 10:47:13
3578213,RS Umum Daerah Bhakti Dharma Husada,257,20,38,58,78,97,199,0,17/Apr/2020 06:00:01
3674168,RS Umum Daerah Kota Tangerang Selatan,186,32,27,59,0,0,127,0,12/Apr/2020 08:39:01
5102043,RS Umum Bhakti Rahayu Tabanan,35,9,11,20,9,5,15,0,19/Apr/2020 02:59:50
5103032,RS Daerah Mangusada,281,64,91,155,51,65,126,0,09/Apr/2020 02:00:58
5271087,RS Umum Daerah Kota Mataram,239,86,91,177,22,46,62,0,21/Feb/2019 04:39:11
5303013,RS Umum Daerah S. K. Lerik,99,10,13,23,0,0,76,0,02/Apr/2020 06:14:47
5303024,RSUD Rote Ndao Ba'a,59,13,22,35,9,10,24,0,14/Feb/2018 08:34:33
6171067,RS Anton Soedjarwo Pontianak,1,0,0,0,0,0,1,0,11/Feb/2019 06:32:10
6311016,RS Umum Daerah Balangan,130,12,10,22,43,65,108,0,19/Apr/2020 01:00:17
6406012,RS Umum Daerah Kabupaten Malinau,136,13,17,30,2,9,106,0,01/Mar/2018 06:10:52
6471073,RS Bhayangkara Balikpapan,87,44,43,87,44,43,0,0,19/Feb/2018 06:24:20
7174035,RS Umum Daerah Kota Kotamobagu,33,16,14,30,1,2,3,0,23/Feb/2018 05:11:59
7109028,RSU Ratatotok - Buyat,51,13,28,41,4,6,10,13,16/Apr/2020 06:07:46
7106018,RS Umum Daerah Maria Walanda Maramis,105,0,20,20,35,55,85,0,01/Mar/2018 08:16:23
7317075,RS Umum Daerah Batara Guru,120,20,23,43,0,0,77,0,13/Apr/2020 03:36:52
7318010,RS Umum Elim Rantepao,2,0,0,0,0,0,2,0,05/Jan/2019 05:15:07
7371234,RS Khusus Daerah Ibu dan Anak Pertiwi,74,7,33,40,0,0,34,0,01/Mar/2018 09:12:04
7406036,RS Umum Daerah Kabupaten Bombana,83,3,6,9,23,23,74,0,08/Dec/2018 10:50:14
7407012,RS Umum Daerah Kabupaten Wakatobi,61,0,0,0,0,0,61,0,22/Feb/2018 06:16:18
7502021,RS Islam,34,5,6,11,13,10,23,0,14/Apr/2020 05:47:58
7504012,RS Umum Daerah Tombulilato,91,30,9,39,25,29,52,0,17/Apr/2020 03:23:48
8101063,RS Umum Daerah Dr. P. P. Magretti Saumlaki,89,19,38,57,11,26,32,0,29/Jan/2019 02:34:38
8109018,RS Umum Daerah Namrole,53,6,2,8,13,32,45,0,22/Feb/2018 11:52:17
8205021,RS Umum Daerah Weda,50,14,36,50,0,0,0,0,19/Feb/2019 04:26:18
8205032,RS Umum Daerah Kab. Pulau Morotai,67,0,0,0,0,0,67,0,28/Feb/2018 07:37:33
1105067,RS Umum Daerah Sultan Alaiddin Said Maulana Abdul,98,24,22,46,20,24,52,0,04/Mar/2019 07:03:19
1105078,RS Umum Graha Bunda,115,49,27,76,7,18,39,0,26/Feb/2018 03:29:09
6271030,RS Siloam Palangka Raya,38,10,1,11,11,14,27,0,14/Apr/2020 11:01:37
1275232,RS Khusus Bedah Accuplast,5,0,0,0,0,0,5,0,17/Apr/2020 10:56:30
1404025,RS Umum  Efarina,197,14,23,37,84,76,160,0,13/Apr/2020 01:57:59
1471079,RS Umum  Syafira,11,0,0,0,0,0,11,0,18/Apr/2020 12:33:14
1505027,RS Umum Daerah Sungai Bahar,40,4,3,7,13,20,33,0,18/Apr/2020 07:54:41
1571067,RS Umum Mayang Medical Centre,105,22,46,68,17,16,37,0,30/May/2018 07:02:30
1671072,RS Dr. Rivai Abdullah,238,6,6,12,127,25,226,0,01/Apr/2020 06:39:27
1704028,RS Umum Daerah Kaur,122,0,0,0,0,0,122,0,04/Mar/2019 05:33:10
2004012,RS Umum Daerah Dabo Kabupaten Lingga,57,5,4,9,26,22,48,0,07/Feb/2018 10:12:29
3174074,RS Umum Daerah Cengkareng,414,87,146,233,0,0,181,0,19/Apr/2020 23:04:50
3202073,RS Umum Betha Medika,142,0,0,0,0,0,142,0,14/Apr/2020 04:27:55
3212042,RS Umum Bhayangkara Indramayu,52,0,0,0,0,0,52,0,27/Jun/2018 06:54:12
3215045,RS Umum Dewi Sri,91,28,15,43,5,6,48,0,16/Apr/2020 03:00:01
3215156,RS Umum Lira Medika,201,20,30,50,4,10,151,40,06/Feb/2018 11:20:00
3216351,RS Umum Kartika Husada,71,13,28,41,12,18,30,0,17/Apr/2020 07:55:29
3271161,RS Umum Melania,100,12,28,40,19,41,60,0,11/Apr/2020 08:33:40
3272062,RS Umum Kartika Kasih,120,26,45,71,25,24,49,0,18/Apr/2020 02:29:56
3304032,RS Umum Islam Banjarnegara,128,90,0,90,38,0,38,0,03/Jan/2019 15:09:23
8106010,RS Umum Piru,61,272,252,524,11,12,-463,0,03/Feb/2018 06:21:09
7313023,RS Umum Daerah Siwa,76,1,4,5,0,0,71,0,19/Apr/2020 02:56:05
1871048,RS Umum Daerah Dr. A. Dadi Tjokrodipo,123,15,5,20,68,35,103,0,08/Apr/2020 08:39:44
1872042,RS Umum Muhammadiyah Metro,154,36,48,84,30,33,70,0,17/Apr/2020 09:28:52
3201083,RS Umum Daerah Leuwiliang,197,48,47,95,12,9,102,0,12/Jul/2018 12:10:47
3206023,RS Umum Daerah Singaparna Medika Citrautama,252,43,58,101,67,92,151,0,17/Apr/2020 04:40:53
3302074,RS Umum An Ni'mah,72,7,15,22,0,0,50,0,02/Mar/2019 20:56:40
3602045,RS Umum Daerah Malingping,59,16,16,32,12,15,27,0,27/Feb/2018 09:23:57
3671136,RS Umum Hermina Tangerang,175,31,60,91,35,49,84,0,18/Apr/2020 05:11:03
5303045,RS Umum Daerah Naibonat,74,20,21,41,0,0,33,0,23/Feb/2018 01:06:37
6171078,RS Pro Medika Pontianak,60,10,20,30,50,40,30,0,09/Mar/2018 03:57:03
9106013,RS Umum Daerah Scholoo Keyen,67,13,8,21,0,0,46,0,21/Feb/2019 08:44:40
9211010,RS Umum Daerah Mulia,68,16,26,42,14,12,26,0,05/Mar/2019 08:51:15
9227011,RS Umum Daerah Supiori,20,5,3,8,0,0,12,0,13/Feb/2018 10:52:21
3314089,RS Umum Daerah dr. Soeratno Gemolong,158,25,38,63,0,0,95,0,01/Apr/2020 14:01:27
9217013,RS Umum Daerah Oksibil,42,0,0,0,0,0,42,0,09/Mar/2018 04:28:44
1102027,RS Umum Daerah Kota Subulussalam,160,6,23,29,0,0,131,0,06/Apr/2020 09:42:32
3671179,RS Mitra Husada,25,4,15,19,2,4,6,0,18/Apr/2020 06:06:31
1410043,RS Umum Daerah  Kabupaten Kepulauan Meranti,139,11,19,30,45,64,109,0,18/Apr/2020 03:17:56
6171085,RS Bersalin Jeumpa Pontianak,28,11,11,22,17,17,6,0,19/Apr/2020 23:01:01
3313053,RS Umum Jati Husada,5,0,0,0,0,0,5,0,16/Apr/2020 16:29:49
3312021,RS Umum Maguan Husada,89,24,29,53,0,0,36,0,13/Apr/2020 08:48:42
3603146,RS Ibu dan Anak Tiara,2,0,0,0,1,1,2,0,16/Apr/2020 12:19:57
3320089,RS Umum PKU Muhammadiyah Mayong,75,24,33,57,0,0,18,0,03/Mar/2019 06:35:46
3404056,RS Jih,220,190,0,190,0,0,30,0,12/Mar/2020 11:04:31
3328078,RS Umum Adella,51,2,19,21,0,0,30,0,11/Apr/2020 09:56:43
9202014,RS Umum Daerah Dekai,66,17,16,33,18,15,33,0,28/Feb/2018 04:00:35
7316026,RS Umum Hj. Puang Sabbe,51,9,6,15,15,23,36,0,06/Dec/2018 04:02:48
7401024,RS Umum Daerah Kabupaten Buton Utara,34,0,1,1,13,14,33,0,14/Apr/2020 09:19:11
1609011,RS Umum Daerah Martapura,50,8,4,12,15,23,38,0,13/Apr/2020 02:01:03
3404179,RS Umum Mitra Paramedika,47,11,18,29,18,18,18,0,08/Mar/2019 07:48:41
3505024,RS Umum  Aulia Blitar,9,4,3,7,1,1,2,0,06/Feb/2018 09:28:54
1403035,RS Umum Daerah  Tengku Sulung,26,7,12,19,2,5,7,0,27/Feb/2018 01:19:41
7604023,RS Umum Daerah Provinsi Sulawesi Barat,146,6,16,22,61,59,124,0,15/Apr/2020 08:39:16
3504056,RS Umum Era Medika,7,3,1,4,0,0,3,0,24/Dec/2018 09:46:08
3674193,RS Buah Hati Ciputat,70,0,0,0,0,0,70,0,25/Aug/2018 12:18:40
1403024,RS Umum Daerah  Raja Musa,30,4,4,8,6,16,22,0,25/Feb/2019 06:31:54
3276039,RS Umum Bhayangkara Brimob,57,19,19,38,38,38,19,0,19/Apr/2020 23:01:01
3278014,RS Umum Tasik Medika Citratama (TMC),168,66,63,129,9,31,39,0,16/Apr/2020 10:21:19
3328035,RS Umum Daerah Suradadi,83,30,30,60,11,12,23,0,26/Oct/2018 01:31:07
7104038,RS Umum Daerah Talaud,122,22,27,49,31,42,73,0,17/Apr/2020 02:20:33
3603157,RS Umum Daerah Balaraja,168,60,77,137,11,16,31,0,26/Nov/2018 01:01:01
3305023,RS Umum Permata Medika Kebumen,55,37,12,49,25,0,6,0,11/Apr/2020 09:55:57
3303097,RS Umum Daerah Panti Nugroho,63,5,27,32,3,28,31,0,18/Apr/2020 04:37:05
1306056,RS Umum Daerah Padang Pariaman,95,9,13,22,1,0,73,0,02/Apr/2020 09:05:39
7371014,RS Umum Daerah Sayang Rakyat,85,2,3,5,0,11,80,0,19/Feb/2018 05:04:29
7108037,RS Umum Daerah Tagulandang,55,9,13,22,12,11,33,0,12/Mar/2018 06:17:43
1116011,RS Umum Daerah Teuku Umar Kabupaten Aceh Jaya,88,17,26,43,25,21,45,0,08/Mar/2019 05:43:51
3603169,Metro Hospitals Cikupa,136,24,55,79,33,17,57,0,16/Apr/2020 06:11:05
3322034,RS Umum Ken Saras,183,23,32,55,0,0,128,0,19/Apr/2020 22:10:06
3325037,RS Umum Qim,6,0,0,0,0,0,6,0,17/Apr/2020 08:51:18
3524042,RS Umum Daerah Ngimbang,103,39,32,71,29,29,32,0,02/Feb/2018 09:42:35
3275046,RS Umum Mitra Keluarga Bekasi Timur,6,0,0,0,0,0,6,0,16/Apr/2020 15:39:39
3601010,RS Umum Daerah Berkah Pandeglang,220,86,102,188,22,38,32,0,25/Feb/2018 04:46:21
1118012,RS Umum Daerah Pidie Jaya,100,0,0,0,0,0,100,0,27/Feb/2018 08:25:42
3518045,RS Umum Bhayangkara Tk. III Nganjuk,80,21,21,42,58,58,38,0,18/Apr/2020 12:01:17
3507096,RS Umum Wava Husada,247,145,0,145,102,0,102,0,16/Apr/2020 05:42:09
3273145,RS Umum Hermina Arcamanik,192,49,89,138,8,10,54,61,01/Jan/2019 10:00:00
3374091,RS Umum Bhayangkara Semarang,11,0,0,0,0,0,11,0,19/Apr/2020 13:13:57
5206027,RS H. L. Manambai Abdulkadir,163,28,23,51,47,66,112,0,18/Apr/2020 02:48:43
3278082,RS Umum Permata Bunda,53,1,23,24,20,0,29,0,17/Apr/2020 08:12:03
5207002,RS Umum Daerah Asy-Syifa Sumbawa Barat,100,52,48,100,0,0,0,0,28/Feb/2018 05:57:13
3404181,RS Umum At-Turost Al-Islamy,9,4,0,4,0,0,5,0,29/Dec/2018 14:09:15
3321034,RS Umum Pelita Anugerah,107,23,35,58,8,14,49,0,18/Apr/2020 05:07:41
3404182,RS Umum Gramedika 10,26,0,0,0,0,0,26,0,18/Apr/2020 09:17:27
3523053,RS Nahdlatul Ulama Tuban,12,0,0,0,0,0,12,0,17/Apr/2020 09:18:34
3508055,RS Djatiroto,35,2,3,5,4,2,30,0,19/Jul/2018 08:47:23
3578322,RS Paru Surabaya,75,18,18,36,19,20,39,0,01/Mar/2019 08:32:32
3504068,RS Umum Bhayangkara Tulungagung,106,18,16,34,30,40,72,0,17/Apr/2020 09:22:25
3504070,RS Umum Islam  Madinah,63,27,29,56,4,5,7,0,08/Apr/2020 03:38:22
3573097,RS Ibu dan Anak Husada Bunda,25,0,5,5,0,20,20,0,17/Apr/2020 04:57:34
3506060,RS Ibu dan Anak Kasih Bunda,1,0,0,0,0,1,1,0,07/Feb/2019 07:00:51
3518046,RS Islam Aisyiyah Nganjuk,38,0,0,0,12,12,38,0,17/Apr/2020 08:35:56
3576074,RS Kamar Medika,2,0,0,0,0,0,2,0,18/Apr/2020 08:16:12
5171216,RS Bhayangkara Denpasar,4,0,0,0,0,0,4,0,16/Apr/2020 12:22:46
6171136,RS Bersalin Nabasa Pontianak,29,0,0,0,0,7,29,0,09/Mar/2018 07:24:54
1222002,RS Umum Daerah Kota Pinang,110,9,12,21,41,48,89,0,17/Apr/2020 06:45:24
3404183,RS Umum PKU Muhammadiyah Gamping,149,75,33,108,0,13,41,0,01/Apr/2020 09:13:53
3404184,RS Umum Bhayangkara POLDA DIY,67,46,0,46,11,12,21,1,19/Apr/2020 09:42:42
3579003,RS Bhayangkara Hasta Brata Batu,5,0,0,0,0,0,5,0,16/Apr/2020 14:43:29
1571159,RS Islam Arafah,104,8,28,36,1,0,68,0,17/Apr/2020 08:26:17
1371446,RS Umum Citra Bunda Medical Center Padang,89,10,10,20,2,2,69,0,12/Jan/2019 08:18:17
1304014,RS Umum Daerah Kabupaten Sijunjung,101,37,64,101,37,66,0,0,21/Feb/2018 12:36:15
3519024,RS Umum Daerah Dolopo,41,20,15,35,4,2,6,0,01/Feb/2018 11:41:15
1307017,RS Ibu dan Anak Rezki Bunda,38,1,13,14,0,0,24,0,22/Feb/2019 06:43:59
3174509,RS Ibu dan Anak St. Yusuf,20,0,11,11,3,7,9,0,16/Apr/2020 04:08:10
5208002,RS Umum Kab. Lombok Utara,116,12,15,27,0,1,89,0,08/Apr/2020 04:30:38
3216386,RS Amanda Cikarang Selatan,90,12,11,23,18,39,67,0,16/Apr/2020 04:36:51
1406043,RS Umum  Mesra,1,0,0,0,0,0,1,0,16/Apr/2020 16:46:53
3573243,RS Ibu dan Anak Mardi Waloeja Kauman Malang,28,0,0,0,0,0,28,0,14/Apr/2020 06:33:47
3513025,RS Ibu dan Anak Fatimah Kraksaan,27,1,1,2,0,8,25,0,27/Dec/2018 11:53:51
3525088,RS Muhammadiyah Gresik,82,0,0,0,2,2,82,0,14/Apr/2020 09:41:23
3516075,RS Mawaddah Medika,31,8,0,8,0,0,23,0,16/Apr/2020 13:30:03
3573246,RSU Hermina Tangkubanprahu,80,3,14,17,63,0,63,0,19/Apr/2020 23:09:37
2002002,RS Umum Daerah  Kabupaten Bintan,55,7,12,19,0,0,36,0,29/Oct/2018 08:02:49
3571147,RS Umum Ratih,64,12,8,20,13,27,44,0,18/Apr/2020 10:35:41
3522059,RS Bhayangkara Wahyu Tutuko Bojonegoro,14,2,0,2,1,0,12,0,16/Apr/2020 13:25:58
3522060,RS Umum Muhammadiyah Kalitidu,2,0,0,0,0,0,2,0,18/Apr/2020 09:22:55
1376011,RS Umum Ibnu Sina Kota Payakumbuh,89,22,17,39,0,0,50,0,02/Feb/2019 09:43:50
2072002,RS Umum Daerah Provinsi Kepulauan Riau Tanjungpina,214,49,33,82,48,84,132,0,18/Apr/2020 11:16:33
1810003,RSU Surya Asih,82,4,2,6,3,12,76,0,16/Apr/2020 10:02:19
1804012,RS Umum Aka Medika Sribhawono,46,4,5,9,13,24,37,0,02/Sep/2018 06:18:27
3273540,RS Khusus Gigi dan Mulut Kota Bandung,4,0,0,0,2,2,4,0,18/Oct/2018 08:08:22
3512035,RS Ibu dan Anak Fatimah Lamongan,2,0,0,0,0,2,2,0,13/Apr/2020 07:22:03
3403022,RS Umum Pelita Husada,44,0,0,0,14,15,44,0,14/Nov/2017 08:59:10
1471383,RS Umum  Sansani,77,5,14,19,0,0,58,0,04/Apr/2020 20:42:09
1408079,RS Umum  Thursina,43,5,2,7,36,36,36,0,11/Apr/2020 05:08:47
1471384,RS Awal Bros A. Yani,187,0,0,0,0,0,187,0,16/Apr/2020 07:14:55
1471386,RS Ibu dan Anak  Annisa,0,0,0,0,1,2,0,0,06/Apr/2018 01:58:32
1406044,RS Ibu Anak  Husada Bunda,30,0,7,7,0,23,23,0,18/Oct/2018 07:07:34
1404027,RS Umum  Amalia Medika,0,0,0,0,0,0,0,0,06/Nov/2018 12:22:26
1275997,RS Umum Bina Kasih,400,39,54,93,161,146,307,0,18/Apr/2020 01:36:15
6474033,RS Amalia Bontang,2,1,0,1,1,1,1,0,17/Jan/2018 08:03:08
1408080,RS Umum  Permata Hati,81,10,17,27,22,32,54,0,19/Apr/2020 03:12:26
3510103,RS Al Huda,176,42,44,86,37,50,90,0,19/Apr/2020 02:54:46
3515122,RSU Mitra Keluarga Waru,118,22,37,59,33,25,59,0,17/Apr/2020 12:00:42
3509135,RS Bina Sehat Jember,177,83,81,164,8,8,13,0,18/Apr/2020 06:09:54
3329102,RS Umum Daerah Bumiayu,108,52,22,74,16,18,34,0,06/Feb/2018 01:57:40
3208059,RS Umum Daerah Linggajati Kuningan,176,28,17,45,24,34,131,0,18/Apr/2020 18:50:16
3674003,RSIA Permata Sarana Husada,26,4,12,16,0,1,10,0,24/Aug/2017 02:24:32
3573252,RS Ibu dan Anak Mutiara Bunda,25,0,13,13,5,7,12,0,14/Apr/2020 05:04:21
1275999,RS Jiwa Bina Karsa Medan,38,23,9,32,4,2,6,0,18/Apr/2020 11:19:04
3404187,RS Khusus Ibu Anak Sadewa,87,24,15,39,2,45,48,0,06/Mar/2018 08:56:23
1110101,RS Umum Bireuen Medical Center,75,1,1,2,3,3,73,0,04/Jan/2019 08:51:49
1275100,RS Umum Methodis Susanna Wesley,0,0,0,0,0,0,0,0,08/Mar/2018 01:28:20
1276075,RS Umum Bidadari,199,35,34,69,65,65,130,0,18/Apr/2020 05:36:42
3502146,RS Umum Muslimat Ponorogo,78,15,18,33,0,0,45,0,18/Apr/2020 11:53:28
1371457,RS Khusus Mata Padang Eye Center,21,10,9,19,2,1,2,0,12/Jan/2019 11:03:45
3206083,RS Ibu dan Anak dr. Hj. Karmini EH,28,0,4,4,0,24,24,0,19/Apr/2020 12:24:19
3329103,RS Umum Islami Mutiara Bunda,67,0,33,33,2,28,34,0,04/Apr/2018 02:38:10
1671325,RS Hermina Palembang,184,36,0,36,0,0,148,0,18/Apr/2020 11:13:42
1505028,RS Umum Daerah Sungai Gelam,50,0,1,1,9,28,49,0,17/Apr/2020 04:36:52
3674004,RS Permata Pamulang,78,20,26,46,15,17,32,0,17/Apr/2020 11:09:36
3674005,RS Sari Asih Ciputat,153,41,40,81,19,38,72,0,16/Apr/2020 05:07:53
1173003,RS Umum Ummi Langsa,98,3,5,8,47,46,90,0,09/Mar/2018 06:57:47
3217002,RS Umum Daerah Cililin,43,6,10,16,10,10,27,0,17/Apr/2020 04:05:08
3578774,RS Ibu dan Anak Nur Ummi Numbi,3,0,0,0,0,0,3,0,19/Apr/2020 05:01:50
3525089,RS Umum Mabarrot MWC NU,40,8,14,22,8,11,18,0,10/Apr/2020 04:00:06
3215158,RS Umum Fikri Medika,35,7,23,30,0,0,5,0,16/Apr/2020 03:15:22
3171511,RS Umum Siloam Asri,0,0,0,0,0,0,0,0,17/Apr/2020 11:05:52
1209077,RS Umum Daerah Tuan Rondahaim Pematang Raya,85,9,5,14,39,39,71,0,14/Apr/2020 09:43:27
1275887,RS Umum Ibnu Saleh,27,4,2,6,11,12,21,0,08/Mar/2018 12:36:52
7505002,RS Umum Daerah dr. Zainal Umar Sidiki,54,1302,1405,2707,1305,1404,-2653,0,20/Mar/2018 09:58:59
3674007,RS Hermina Ciputat,132,46,59,105,6,17,27,0,17/Apr/2020 05:29:07
8103002,RS Umum Daerah Banda,50,0,2,2,20,28,48,0,19/Apr/2020 11:31:50
6108012,RS Bergerak Badau Kapuas Hulu,10,0,1,1,5,4,9,0,15/Apr/2020 06:58:56
3603175,RS Umum Murni Asih,16,0,0,0,0,0,16,0,14/Jan/2019 07:51:40
1223002,RS Umum Daerah  Aek Kanopan,61,5,5,10,25,23,51,0,08/Mar/2019 12:10:36
9203016,RS TNI Angkatan Darat Marthen Indey Jayapura,136,0,0,0,0,0,136,0,11/Jan/2019 05:21:55
7309044,RS AU dr. Dody Sardjoto,18,6,4,10,4,3,8,0,22/Feb/2018 05:54:35
3671203,RS Awal Bros Kota Tangerang,162,50,66,116,23,18,46,0,17/Apr/2020 06:34:44
6208013,RS Umum Daerah Hanau,60,4,16,20,19,21,40,0,18/Apr/2020 04:59:00
3603178,RS Ibu dan Anak Bunda Sejahtera,1,0,0,0,0,0,1,0,16/Apr/2020 14:59:59
1902011,RS Umum Almah,30,2,1,3,27,27,27,0,21/Dec/2018 01:16:57
3201232,RS Umum Daerah Cileungsi,124,81,81,162,43,43,-38,0,06/Feb/2018 22:02:54
3603180,RS Ciputra,13,0,0,0,0,0,13,0,17/Apr/2020 10:56:54
1275888,RS Umum Martha Friska Multatuli,10,2,4,6,2,2,4,0,08/Mar/2018 12:38:31
7271128,RS Umum  Sis Al Jufri Palu,6,0,0,0,0,0,6,0,12/Apr/2020 11:51:50
6105027,RS Bergerak Balai Karangan,11,0,1,1,5,5,10,0,16/Jan/2019 05:32:11
3375073,RS Umum H. A. Zaky Djunaid,59,23,25,48,4,11,11,0,22/Jan/2018 07:10:19
5103034,RS Khusus Bedah BIMC Nusa Dua,2,0,0,0,0,0,2,0,18/Apr/2020 09:36:12
3205022,RS Umum Daerah Pameungpeuk Prov. Jabar,60,10,18,28,15,18,32,0,05/Dec/2018 05:30:40
3216397,RS Umum Asri Medika,22,3,4,7,7,4,15,0,30/Oct/2018 11:51:24
6171138,RS Umum Daerah Sultan Syarif  Mohammad Alkadri,115,39,42,81,8,18,34,0,06/Dec/2018 04:28:19
1275889,RS Umum Murni Teguh Memorial Hospital,279,113,114,227,15,15,52,0,17/Apr/2020 03:44:27
3204123,RS Ibu dan Anak Humana Prima,44,0,0,0,0,0,44,0,24/Dec/2018 01:19:34
3175408,RS Umum Firdaus,148,0,0,0,0,0,148,0,16/Apr/2020 07:07:59
3313054,RS Umum Indo Sehat Karangayar,41,0,3,3,0,0,38,0,17/Apr/2020 03:08:47
7315016,RS Umum Aisyiyah St. Khadijah,46,0,0,0,0,0,46,0,16/Apr/2020 07:19:11
3471121,RS Paru Respira,24,0,0,0,24,24,24,0,18/Apr/2020 12:43:22
6271068,RS Jiwa Kalawa Atei,52,24,7,31,1,19,21,0,15/Apr/2020 04:34:13
3603181,RS Bethsaida,151,18,26,44,50,57,107,0,17/Apr/2020 04:38:23
1219003,RS Umum Daerah Batu Bara,70,1,2,3,27,40,67,0,06/Mar/2019 07:49:01
1611042,RS Umum Daerah Kabupaten Empat Lawang,84,4,8,12,30,42,72,0,15/Apr/2020 04:35:25
1771002,RS Umum Daerah Harapan dan Doa,103,14,20,34,30,25,69,0,08/Oct/2018 07:15:55
1278002,RS Umum Bethesda Gunungsitoli,114,19,12,31,0,0,83,0,18/Apr/2020 05:45:01
1471389,RS JMB Pekanbaru,32,0,0,0,0,0,32,0,06/Apr/2018 02:04:22
3517091,RS Umum Moedjito Dwidjosiswojo,34,0,0,0,0,0,34,0,12/Feb/2019 08:38:39
3512036,RS Umum Daerah Besuki Kabupaten Situbondo,71,9,10,19,27,25,52,0,01/Apr/2020 04:05:52
3521014,RS Umum Widodo,107,13,25,38,2,9,69,0,14/Apr/2020 04:44:50
1901043,RS Umum Daerah Dr. (H.C.) Ir. Soekarno,71,19,26,45,7,8,26,0,14/Apr/2020 04:22:17
3201236,RS Umum Medika Dramaga,98,12,9,21,40,37,77,0,13/Apr/2020 07:22:28
1871439,RS Ibu dan Anak Restu Bunda,61,1,17,18,0,44,43,0,16/Apr/2020 04:48:37
1671328,RS Khusus Gigi dan Mulut Palembang Provinsi Sumate,11,0,0,0,5,6,11,0,18/Apr/2020 03:18:14
1610003,RS Umum Daerah Kabupaten Ogan Ilir,50,10,13,23,15,12,27,0,13/Feb/2018 11:40:12
3509136,RS Umum Citra Husada Jember,97,22,28,50,19,28,47,0,16/Apr/2020 08:05:17
3673004,RS Umum Daerah Banten,405,23,56,79,50,15,326,0,16/Apr/2020 11:24:58
3301107,RS Umum Santa Maria Cilacap,72,6,15,21,20,31,51,0,17/Apr/2020 04:05:13
3524043,RS Bedah Mitra Sehat,22,5,4,9,3,3,13,0,09/Jan/2019 06:49:14
3306108,RS Ibu dan Anak Kasih Ibu Purworejo,0,0,0,0,0,0,0,0,16/Apr/2020 10:56:59
3314092,RS Umum Islam Yakssi Gemolong,70,1,4,5,0,0,65,0,18/Apr/2020 05:19:23
3404189,RS UGM,13,1,0,1,0,0,12,0,13/Apr/2020 07:44:58
8172002,RS Umum Daerah Maren Kota Tual,49,2,2,4,18,24,45,0,19/Apr/2020 01:24:57
3174515,RS Khusus Mata Jakarta Eye Center Kedoya,19,5,1,6,6,2,13,0,16/Apr/2020 13:49:30
3216388,RS Umum Cibitung Medika,213,44,63,107,28,2,106,0,01/Oct/2018 13:27:27
3277021,RS Umum Kasih Bunda,2,0,0,0,0,0,2,0,16/Apr/2020 14:57:37
3312308,RS Umum Mulia Hati Wonogiri,69,11,13,24,0,0,45,0,04/Apr/2020 20:34:38
3215161,RS Umum Mitra Family,0,0,0,0,0,0,0,0,12/Oct/2017 11:49:07
1605044,RS Umum Daerah Muara Beliti,60,5,6,11,45,44,49,0,13/Mar/2018 11:24:11
3172749,RSK Pusat Otak Nasional,203,71,56,127,0,0,76,0,09/Mar/2019 00:13:10
3201241,RS Umum Ummi,10,0,0,0,0,0,10,0,16/Apr/2020 16:54:07
7107003,RS Umum Daerah Bolaang Mongondow Utara,95,23,17,40,19,37,55,0,17/Apr/2020 05:55:26
3517089,RS Umum Daerah Ploso,41,3,9,12,9,20,29,0,17/Apr/2020 02:36:08
3671207,RS Dinda,123,33,33,66,21,31,57,0,17/Apr/2020 02:14:45
6371153,RS Khusus Gigi dan Mulut Gusti Hasan Aman,8,0,0,0,0,0,8,0,27/Feb/2018 09:01:56
7371408,RS Universitas Hasanuddin,200,11,12,23,166,11,177,0,20/Apr/2020 00:18:10
3216409,RS Umum Cikarang Medika,48,0,0,0,18,22,48,0,21/Mar/2020 04:12:51
3216413,RS Umum Kartika Husada Setu,19,0,0,0,0,0,19,0,18/Apr/2020 12:15:33
3216415,RS Umum Ridhoka Salma,61,25,22,47,6,4,14,0,16/Dec/2018 08:22:45
3509137,RS Ibu dan Anak Srikandi IBI Jember,45,0,0,0,0,0,45,0,05/Feb/2018 05:59:04
3216417,RS Umum Tiara,22,6,13,19,3,0,3,0,22/Dec/2018 09:49:49
3305118,RS Umum Muhammadiyah Kutowinangun,12,2,2,4,10,10,8,0,15/Apr/2020 10:01:01
7502034,RS Umum Daerah dr. Hasri Ainun Habibie,145,8,18,26,55,65,119,0,18/Apr/2020 01:43:32
1806036,RS Umum HI. Muhammad Yusuf,37,7,5,12,9,17,25,0,11/Apr/2020 03:49:05
1208056,RS Umum Setio Husodo,2,0,0,0,0,0,2,0,17/Apr/2020 09:06:07
3404190,RS Umum Mitra Sehat,30,2,0,2,16,12,28,0,04/Mar/2018 06:47:30
1174019,RS Umum Bunga Melati,370,251,250,501,29,29,-131,0,04/Jun/2018 10:03:15
1271032,RS Umum Metta Medika,98,19,21,40,0,3,58,0,14/Apr/2020 12:40:08
6271024,RS Islam PKU Muhammadiyah Palangkaraya,60,151,157,308,2,0,-248,0,03/Apr/2018 05:25:18
6303028,RS Ibu dan Anak Mutiara Bunda,30,7,6,13,2,13,17,0,04/Jan/2019 05:22:00
1406045,RS Ibu Anak  Bunda Anisyah,27,2,10,12,0,0,15,0,01/Apr/2020 15:33:34
3173697,RS Khusus Gigi dan Mulut Ladokgi TNI AL R.E. Marta,0,0,0,0,0,0,0,0,16/Apr/2020 10:55:36
1671333,RS Pelabuhan Palembang,64,3,18,21,14,15,43,0,19/Apr/2020 01:36:20
3671208,RS Umum Daerah Kota Tangerang,101,7,5,12,0,0,89,0,18/Apr/2020 02:03:31
3674012,RS Bunda Dalima,27,0,0,0,0,0,27,0,24/Dec/2018 11:22:47
1407012,RS Umum  Awal Bros Ujung Batu,73,18,34,52,14,7,21,0,15/Apr/2020 12:35:16
3216420,RS Umum Medirossa 2,104,19,30,49,15,40,55,0,06/Apr/2020 03:07:41
1504018,RS Mitra Medika Batang Hari,60,15,24,39,16,5,21,0,18/Apr/2020 03:59:43
3512037,RS Umum Daerah Asembagus Kabupaten Situbondo,50,13,9,22,14,14,28,0,16/Feb/2019 07:32:57
1471390,RS Umum  Awal Bros Panam,161,59,86,145,0,0,16,0,17/Apr/2020 03:42:56
1275998,RS Ibu dan Anak Stella Maris,0,0,0,0,0,0,0,0,17/Apr/2020 11:38:05
3603182,RS Medika Lestari,103,0,0,0,30,25,103,0,17/Apr/2020 02:50:39
1275898,RS Khusus Mata SMEC,18,3,2,5,6,5,13,0,17/Apr/2020 07:02:45
3301108,RS Umum Aghisna Medika Kroya,64,21,15,36,0,0,28,0,07/Nov/2018 09:11:29
1471391,RS Khusus  Mata Pekanbaru Eye Center,3,0,0,0,0,0,3,0,06/Apr/2018 01:56:39
3216423,RS Umum Kartika Husada,6,0,0,0,0,0,6,0,16/Apr/2020 11:22:19
1809002,RS Umum Daerah Pesawaran,102,9,11,20,30,52,82,0,19/Apr/2020 04:39:05
1407013,RS Umum Azzahra,46,4,10,14,0,0,32,0,13/Apr/2020 20:18:01
3671209,RS Sari Asih Sangiang,4,0,0,0,0,0,4,0,18/Apr/2020 12:29:00
1971003,RS Ibu dan Anak Muhaya,1,0,0,0,0,0,1,0,16/Apr/2020 15:16:31
5206029,RS Umum Daerah Sondosia Kab. Bima,49,8,10,18,18,13,31,0,10/Feb/2018 09:06:05
3310417,RS Umum Islam Cawas Klaten,58,0,0,0,17,20,58,0,16/Apr/2020 13:11:58
1407014,RS Umum  Surya Insani,52,18,18,36,10,6,16,0,16/Apr/2020 04:15:54
1212176,RS Umum Joko,50,313,581,894,0,0,-844,0,04/Jan/2019 07:03:19
6110013,RS Umum Citra Husada Nanga Pinoh,41,15,17,32,5,4,9,0,17/Jul/2018 06:55:12
3507108,RS Umum Universitas Muhammadiyah Malang,158,34,45,79,33,43,79,0,15/Apr/2020 03:52:59
1108017,RS Umum Ibnu Sina,111,43,22,65,10,36,46,7,01/Mar/2018 20:34:02
3374365,RS Umum Hermina Banyumanik Semarang,76,18,14,32,24,20,44,0,15/Apr/2020 12:44:32
1211126,RS Umum Amanda,82,10,13,23,0,0,59,0,18/Apr/2020 10:36:33
3374367,RS Umum Nasional Diponegoro,97,11,21,32,37,28,65,0,06/Mar/2019 03:39:51
1671335,RS Siloam Sriwijaya Palembang,1,0,0,0,0,0,1,0,17/Apr/2020 19:24:12
7201012,RS Umum Daerah Trikora Salakan,63,8,7,15,30,33,48,0,13/Apr/2020 07:17:37
3403023,RS Umum Panti Rahayu,45,10,20,30,0,0,15,0,18/Apr/2020 03:09:36
1805046,RS Umum Kartini,78,8,12,20,21,36,58,0,15/Aug/2018 06:00:21
7209002,RS Umum Daerah Wakai,61,2,0,2,0,0,59,0,10/Apr/2020 04:39:04
3372236,RS Umum Hermina Solo,91,8,74,82,7,12,9,0,16/Apr/2020 10:25:41
3525093,RS Fathma Medika,80,8,13,21,27,32,59,0,19/Apr/2020 08:36:05
3311225,RS Umum PKU Muhammadiyah Sukoharjo,49,3,11,14,0,0,35,0,02/Jan/2019 10:23:36
1871443,RS Ibu dan Anak Santa Anna,25,0,0,0,0,0,25,0,17/Apr/2020 01:35:45
3324038,RS Umum Baitul Hikmah,50,0,0,0,0,0,50,0,25/Sep/2017 06:33:57
3578786,RS Mata Masyarakat Jawa Timur,49,0,0,0,25,24,49,0,15/Feb/2018 05:56:08
6303030,RS Umum Aveciena Medika,44,9,10,19,11,12,25,0,06/Aug/2017 01:52:05
7210002,RS Umum Daerah Tora Belo,135,20,30,50,33,50,85,0,17/Feb/2018 07:32:45
7604026,RS Umum Daerah Kabupaten Mamuju Tengah,83,2,0,2,31,45,81,0,19/Apr/2020 10:09:01
1218026,RS Umum Pabatu,4,0,0,0,0,0,4,0,17/Apr/2020 13:10:43
3329109,RS Umum Amanah Mahmudah,3,0,2,2,1,1,1,0,29/Aug/2017 07:02:29
5303028,RS Siloam Kupang,17,0,0,0,0,0,17,0,16/Apr/2020 13:52:46
3671210,RS Permata Ibu,68,14,31,45,7,16,23,0,19/Apr/2020 06:51:47
3528027,RS Umum Mohammad Noer Pamekasan,95,17,16,33,30,28,62,0,18/Apr/2020 09:25:14
3307051,RS Umum  PKU Muhammadiyah Wonosobo,14,2,3,5,2,3,9,0,14/Apr/2020 05:57:06
3524047,RS Muhammadiyah Babat,53,8,11,19,12,14,34,0,09/Apr/2020 09:07:07
3519026,RS Paru Manguharjo Madiun,42,3,1,4,19,19,38,0,12/Apr/2020 06:42:00
7411908,RS Umum Daerah Kabupaten Kolaka Timur,30,10,11,21,14,16,9,0,01/Mar/2019 05:52:39
1409013,RS Umum  Indah,56,4,5,9,24,23,47,0,08/Apr/2020 05:25:58
3175410,RS Umum Pekerja,42,0,0,0,0,0,42,0,18/Apr/2020 08:03:17
7412002,RS Umum Daerah Kabupaten Konawe Kepulauan,32,8,9,17,12,19,15,0,01/Nov/2018 06:24:44
6106021,RSIA Permata Bunda,35,4,9,13,7,22,22,0,02/Jan/2019 08:18:56
1901044,RS Umum Daerah DR. Eko Maulana Ali,52,0,0,0,23,29,52,0,06/Apr/2020 04:11:24
3201245,RS Umum Karya Bhakti Pratiwi,97,13,0,13,0,0,84,0,06/Sep/2018 02:12:21
7401039,RS Umum Daerah Kabupaten Buton Selatan,15,5,4,9,0,0,6,0,26/Nov/2018 08:46:02
6471079,RS Umum Daerah Beriman,128,33,46,79,22,26,49,0,17/Apr/2020 04:15:58
1609012,RS Islam At-Taqwa Gumawang,4,2,0,2,2,0,2,0,24/Dec/2018 10:21:44
3525095,RSU PKU Muhammadiyah Sekapuk,55,7,9,16,20,19,39,0,19/Apr/2020 11:57:17
3401052,RS Umum Daerah Nyi Ageng Serang,67,43,0,43,24,0,24,0,09/Mar/2019 00:13:09
6310016,RS Bersalin Paradise,15,0,15,15,0,0,0,0,11/Apr/2018 11:37:57
3205023,RS Umum Nurhayati Garut,60,9,16,25,0,0,35,0,12/Feb/2019 07:15:29
3520015,RS Ibu dan Anak Samudra Husada,25,5,7,12,10,3,13,0,19/Apr/2020 05:32:53
3216427,RS Dokter Adam Talib Cikunir,62,0,0,0,3,3,62,0,04/Jan/2019 11:21:15
3525096,RS Petrokimia Gresik Driyorejo,6,2,0,2,0,0,4,0,06/Mar/2018 10:33:19
3404191,RS Universitas Ahmad Dahlan,49,7,0,7,42,0,42,0,19/Apr/2020 23:23:03
9218002,RS Umum Daerah Karubaga,23,0,0,0,10,13,23,0,15/Apr/2020 09:45:46
1805048,RS Umum Az - Zahra,70,10,17,27,9,13,43,0,15/Apr/2020 05:00:13
3273541,RS Ibu dan Anak Harapan Bunda Bandung,39,2,6,8,0,0,31,1,19/Apr/2020 22:44:13
3273542,RS Umum Santosa Hospital Bandung Kopo,278,48,76,124,0,0,154,0,16/Apr/2020 06:17:32
1306057,RS Paru Sumatera Barat,21,1,0,1,10,10,20,0,01/Mar/2019 06:14:41
3173698,RS Umum Daerah Sawah Besar,30,16,0,16,7,0,14,0,16/Apr/2020 12:42:59
6403017,RS Umum Daerah Dayaku Raja,131,52,165,217,42,15,-86,0,17/Apr/2020 02:49:39
6271026,RS Umum Kelas D Kota Palangka Raya,70,0,3,3,30,37,67,0,18/Apr/2020 04:12:06
1471392,RS Umum  Universitas Riau,57,0,0,0,0,0,57,0,23/Apr/2018 08:10:21
3171790,RS Umum Daerah Kecamatan Tebet,37,12,23,35,0,2,2,0,04/Oct/2017 06:20:56
1571165,RS Umum Erni Medika,57,6,1,7,0,0,50,0,11/Jun/2018 08:24:24
3403024,RS Umum PKU Muhammadiyah Wonosari,36,19,0,19,17,0,17,0,19/Apr/2020 23:23:12
3175412,RS Umum Daerah Tugu Koja,44,9,5,14,0,16,30,0,15/Apr/2020 10:02:46
3171792,RS Umum Daerah Jagakarsa,26,4,10,14,9,11,12,0,10/Apr/2020 03:57:41
3171791,RS Umum Pesanggrahan,37,3,4,7,16,14,30,0,18/Apr/2020 10:54:30
3172762,RS Umum Daerah Ciracas,40,7,9,16,15,17,24,0,13/Apr/2020 03:14:51
3173701,RS Umum Daerah Johar Baru,39,11,9,20,8,7,19,0,17/Apr/2020 08:20:50
3171793,RS Umum Daerah Mampang Prapatan,35,19,0,19,16,0,16,0,17/Apr/2020 08:26:53
3172761,RS Umum Daerah Kramat Jati,69,10,2,12,39,4,57,0,03/Oct/2017 22:33:55
3174518,RS Umum Daerah Kecamatan Kalideres,38,6,5,11,7,20,27,0,19/Apr/2020 03:42:02
9236003,RS Umum Daerah Pratama Waghete,13,3,2,5,2,6,8,0,26/Feb/2018 07:48:24
3212054,RS Umum MM Indramayu,103,0,0,0,38,63,103,0,16/Apr/2020 05:41:02
1671340,RS Ibu dan Anak Az-Zahra Palembang,42,16,0,16,11,20,26,0,11/Apr/2020 04:45:09
3175413,RS Umum Daerah  Pademangan,47,7,2,9,26,14,38,0,14/Apr/2020 03:32:44
3174517,RS Umum Daerah  Kembangan,37,6,11,17,8,11,20,0,15/Apr/2020 04:47:55
3173699,RS Umum Daerah Kemayoran,65,42,24,66,15,0,-1,0,06/Dec/2018 10:13:53
3203038,RS Umum Dr. Hafiz,137,7,6,13,10,12,124,0,16/Apr/2020 06:07:43
1671341,RS Ibu dan Anak Marissa Palembang,12,0,206,206,0,206,-194,0,05/Jan/2019 08:43:42
3310421,RS Umum Daerah Bagas Waras,193,46,56,102,10,46,91,0,06/Mar/2019 08:44:20
3171795,RS Umum Daerah Pasar Minggu,237,54,32,86,70,85,151,0,18/Apr/2020 02:01:39
3404193,RS Umum Hermina Yogya,60,12,20,32,27,26,28,0,17/Apr/2020 04:43:12
3573258,RS Umum Daerah Kota Malang,84,9,9,18,20,46,66,0,27/Nov/2018 06:29:50
1402013,RS Umum  Kasih Ibu Rengat,8,1,5,6,0,0,2,0,17/Apr/2020 14:14:51
1171150,RS Umum Pertamedika Ummi Rosnati,105,34,35,69,18,18,36,0,27/Feb/2018 09:18:53
3217004,RS Umum Daerah Lembang,59,2,10,12,22,23,47,0,18/Apr/2020 07:23:11
3173704,RS Khusus Bedah Salemba Satu,0,0,0,0,0,0,0,0,16/Apr/2020 11:49:30
1671343,RS Umum Ar-Rasyid Palembang,99,0,0,0,0,0,99,0,02/Apr/2020 10:20:03
1871446,RS Ibu dan Anak Bunda Asy Syifa,0,0,0,0,0,0,0,0,18/Apr/2020 11:32:34
1402014,RS Ibu dan Anak  Safira,62,0,2,2,0,0,60,0,13/Apr/2020 09:30:59
1471395,RS Ibu Anak  Budhi Mulia,10,0,0,0,0,0,10,0,06/Apr/2018 02:15:42
3506064,RS Ibu dan Anak Permata Hati Pare Kediri,8,0,1,1,0,6,7,0,11/Feb/2019 08:52:26
6306024,RS Umum Daerah Daha Sejahtera,59,11,16,27,21,21,32,0,28/Mar/2020 02:06:17
6301015,RS Borneo Citra Medika,87,18,38,56,10,10,31,0,15/Apr/2020 12:42:01
3471377,UPT Rumah Sakit Pratama Kota Yogyakarta,87,1,0,1,3,40,86,0,09/Feb/2018 12:02:32
1110104,RS Umum Jeumpa Hospital,73,0,0,0,0,0,73,0,27/Feb/2018 07:40:32
3174523,RS Umum Daerah Matraman,30,4,5,9,0,0,21,0,15/Apr/2020 09:12:09
3175416,RS Umum Daerah  Tanjung Priok,56,3,4,7,10,20,49,0,16/Apr/2020 12:20:31
3173705,RS Umum Daerah Tanah Abang,28,9,9,18,18,18,10,0,17/Apr/2020 12:51:51
3510107,RS Ibu dan Anak Abdhi Famili,30,3,9,12,4,14,18,0,04/Mar/2019 06:29:13
3671214,RS Tiara,60,11,33,44,20,30,16,0,07/Apr/2020 23:58:02
3603186,RS Ibu dan Anak Assyifa,1,0,0,0,0,0,1,0,17/Apr/2020 13:38:11
1812003,RS Umum Daerah Tulang Bawang Barat,50,3,0,3,21,26,47,0,17/Apr/2020 08:52:58
3174525,RS Umum Daerah Taman Sari,37,7,0,7,30,0,30,0,17/Apr/2020 09:42:02
3318113,RS Umum As-Suyuthiyyah,50,9,15,24,14,8,26,0,17/Apr/2020 03:26:35
1471396,RS Umum  Aulia Hospital,154,16,33,49,19,12,105,0,19/Apr/2020 10:00:04
3573261,RS Ibu dan Anak Rumkitban 05.08.02 Malang,21,0,0,0,0,0,21,0,14/Apr/2020 07:01:40
3203039,RS Umum Daerah Pagelaran,145,18,20,38,36,73,107,0,02/Nov/2018 10:21:08
3173706,RS Umum Hermina Kemayoran,174,26,57,83,39,53,91,0,18/Apr/2020 01:00:29
3522064,RS Ibu dan Anak Fatma,36,0,0,0,0,0,36,0,11/Jun/2018 07:01:53
7202016,RS Pratama dr. Abdul Chalik Masulili,10,2,4,6,3,1,4,0,08/Mar/2019 06:02:59
3671217,RS Ibu dan Anak Karunia Bunda,26,0,0,0,0,0,26,0,14/Apr/2020 10:52:50
9229002,RS Pratama Elvrida Sara,20,2,2,4,8,8,16,0,13/Mar/2018 03:32:51
3216435,RS Umum Tarumajaya,45,7,4,11,16,15,34,0,19/Nov/2018 03:03:43
6310018,RS Umum Marina Permata,76,3,9,12,36,28,64,0,18/Apr/2020 03:48:17
6172002,RS Ibu dan Anak Wempe Singkawang,12,0,0,0,0,0,12,0,09/Mar/2018 01:00:16
3525099,RS Umum Rachmi Dewi,20,0,1,1,10,10,19,0,28/Aug/2018 05:51:06
3272075,RS Umum Daerah Al-Mulk,40,4,6,10,12,18,30,0,18/Apr/2020 04:25:22
3505041,RS Umum Al-Ittihad,72,0,0,0,0,0,72,0,09/Aug/2017 01:43:07
3510108,RS Al-Rohmah Banyuwangi,51,8,8,16,21,22,35,0,14/Apr/2020 03:58:55
7271132,RS Samaritan Palu,107,9,8,17,37,55,90,0,06/Mar/2019 07:13:02
7326002,RS Umum Daerah Pongtiku,50,21,19,40,5,5,10,0,19/Feb/2018 02:39:18
3671219,RS Ibu dan Anak Gebang Medika,24,0,7,7,6,11,17,0,17/Apr/2020 07:37:31
7308059,RS Umum Daerah Datu Pancaitana,55,12,15,27,0,0,28,0,17/Jan/2019 10:04:56
3217006,RS Umum IMC,0,0,0,0,0,0,0,0,27/Mar/2020 04:17:50
6303033,RS Umum Ciputra Mitra Hospital,281,10,15,25,0,0,256,0,15/Apr/2020 04:02:38
6472128,RS Umum Daerah KORPRI Provinsi Kalimantan Timur,12,2,0,2,4,6,10,0,19/Feb/2019 10:09:55
1109031,RS Islam Ibnu Sina Sigli,41,10,15,25,5,13,16,0,31/Dec/2018 07:18:58
6471085,RS Ibu Anak Asih  Balikpapan,1,0,1,1,0,0,0,0,22/Feb/2019 06:12:50
7371426,RS Hermina Makassar,91,10,14,24,19,48,67,0,17/Apr/2020 04:15:43
1811002,RS Umum Daerah Ragab Begawe Caram,84,7,7,14,0,0,70,0,18/Apr/2020 01:39:13
5315003,RS Umum Daerah Komodo,108,7,4,11,3,3,97,0,14/Mar/2018 05:55:57
3673010,RS Fatimah,0,0,0,0,0,0,0,0,18/Apr/2020 11:00:24
8272003,RS Umum Sofifi,50,15,16,31,10,9,19,0,28/Feb/2018 06:26:49
1371463,RS Khusus Bedah Kartika Docta,27,4,1,5,10,12,22,0,30/Mar/2020 05:39:15
1273106,RS Umum Tiara Kasih Sejati,2,0,0,0,0,0,2,0,05/Mar/2019 10:48:28
1302012,RS Umum BKM,51,3,1,4,47,0,47,0,06/Dec/2018 07:02:47
3275060,RS Umum Satria Medika,84,7,10,17,0,0,67,0,04/Apr/2020 09:03:44
1213059,RS Umum Putri Bidadari,312,7,35,42,126,122,270,0,18/Apr/2020 12:10:30
1208059,RS Umum Bunda Mulia,6,0,2,2,1,2,4,0,08/Mar/2019 02:58:43
3206084,RS Ibu dan Anak Respati,6,1,2,3,2,1,3,0,02/Apr/2020 05:50:12
7208115,RS Umum Daerah Buluye Napoae Moutong,50,1,1,2,24,24,48,0,18/Apr/2020 03:07:31
3402080,RS Khusus Ibu dan Anak Kahyangan,18,0,0,0,0,0,18,0,13/Apr/2020 07:21:55
3603188,RS Ibu dan Anak Bunda Sejati,40,0,0,0,0,0,40,0,27/Dec/2018 11:55:04
1902012,RS Utama,198,9,9,18,0,0,180,0,16/Apr/2020 11:20:05
5201012,RS Umum Daerah Awet Muda Narmada,844,242,282,524,20,49,320,491,04/Jul/2017 14:48:09
3508058,RS Umum Daerah Pasirian Kabupaten Lumajang,86,25,33,58,13,15,28,0,16/Apr/2020 06:50:35
7171103,RS Umum Daerah Provinsi Sulawesi Utara,100,25,30,55,0,0,45,0,20/Feb/2018 05:40:29
3303101,RS Umum Siaga Medika Purbalingga,72,31,30,61,7,4,11,0,19/Apr/2020 01:54:17
7371427,RS Gigi dan Mulut Ladokgi TNI AL Yos Sudarso,2,0,0,0,0,0,2,0,22/Feb/2018 07:54:56
3471378,RS Khusus Ibu dan Anak Fajar,15,0,0,0,0,0,15,0,18/Mar/2019 18:20:55
1377007,RS Umum Daerah Dr Sadikin Kota Pariaman,24,88,206,294,8,16,-270,0,01/Mar/2018 09:15:00
7205024,RS Umum Pratama Tambu,34,1,4,5,17,12,29,0,18/Apr/2020 11:43:15
2071059,RS Umum Soedarsono Darmosoewito,2,0,0,0,0,0,2,0,18/Apr/2020 09:12:38
3204130,RS Mata Bandung Eye Center,0,0,0,0,0,0,0,0,11/Jul/2018 12:17:51
3305120,RS Umum Daerah Prembun,120,34,34,68,78,78,52,0,17/Apr/2020 08:49:15
6471086,RS Hermina Balikpapan,74,0,0,0,0,0,74,0,16/Apr/2020 06:42:31
1371464,RS. Universitas Andalas,118,9,11,20,133,46,98,0,17/Apr/2020 09:33:24
3212055,RS Umum Pertamina Balongan Indramayu,13,1,3,4,0,0,9,0,14/Apr/2020 11:40:47
3325039,RS Umum Daerah Limpung,34,3,2,5,14,15,29,0,18/Apr/2020 04:02:19
1371465,RS Ibu dan Anak Restu Ibu,25,0,25,25,0,0,0,0,24/Jan/2019 08:29:47
3311229,RS Umum Indriati,143,22,48,70,34,39,73,0,18/Apr/2020 04:26:30
7414002,RS Umum Daerah Kabupaten Buton Tengah,42,0,0,0,17,25,42,0,26/Mar/2020 05:33:29
1508002,RS Umum Setia Budi,26,3,5,8,0,0,18,0,24/Jan/2019 12:24:01
6404051,RS Umum Daerah Sangkulirang,50,4,2,6,18,26,44,0,15/Apr/2020 04:57:40
6405012,RS Umum Daerah Talisayan,30,6,2,8,9,13,22,0,06/Mar/2019 04:57:56
5102047,RS Nyitdah,67,4,1,5,23,25,62,0,02/Mar/2019 04:11:05
5101055,RS Umum Balimed Negara,62,2,0,2,18,18,60,0,08/Dec/2018 03:56:08
5371059,RS Jiwa Naimata,50,25,24,49,0,1,1,0,28/Feb/2019 05:41:45
3602012,RS Kartini,16,0,0,0,8,8,16,0,29/Aug/2017 09:00:11
3201250,RS Ibu dan Anak Permata Pertiwi,35,0,10,10,0,25,25,0,16/Apr/2020 07:09:27
6571044,RS Umum Kota Tarakan,117,0,0,0,0,0,117,0,10/Apr/2020 09:54:48
3674018,RS Pondok Indah Bintaro Jaya,2,0,0,0,0,0,2,0,18/Apr/2020 10:32:48
3525100,RS Ibu dan Anak Amalia,39,0,0,0,0,0,39,0,06/Mar/2018 10:39:04
5108077,RS Umum Daerah Tangguwisia,50,15,11,26,7,17,24,0,17/Apr/2020 03:53:21
3217007,RS Umum Daerah Cikalong Wetan,370,0,37,37,297,42,333,0,19/Apr/2020 23:23:53
3175417,RS Mata Primasana,18,1,2,3,8,7,15,0,19/Feb/2019 05:41:50
3275062,RS Siloam Bekasi Timur,9,0,0,0,0,0,9,0,16/Apr/2020 16:14:19
2171061,RS Bhayangkara Batam Polda Kepri,71,15,1,16,15,11,55,0,11/Apr/2020 08:44:19
1302013,RS Umum Daerah Tapan,16,1,1,2,5,5,14,0,28/Feb/2019 05:23:23
3171801,RS Umum Daerah Kebayoran Baru,6,0,0,0,0,0,6,0,16/Apr/2020 10:30:07
3528028,RS Umum Daerah Waru Pamekasan,62,18,23,41,7,13,21,0,01/Mar/2018 04:32:54
1671347,RS Umum Daerah Siti Fatimah Provinsi Sumatera Sela,222,15,17,32,0,0,190,0,14/Apr/2020 08:13:08
6501013,RS Pratama Long Ampung,20,2,2,4,8,8,16,0,13/Mar/2018 08:25:54
5171220,RS Umum Daerah Bali Mandara Provinsi Bali,231,90,56,146,20,20,85,20,07/Dec/2018 22:21:01
3471380,RS Siloam Yogyakarta,11,0,0,0,0,0,11,0,17/Apr/2020 14:12:38
3207057,RSU Dadi Keluarga Ciamis,87,15,12,27,60,0,60,0,19/Apr/2020 23:31:00
1275922,RS Khusus Mata Provinsi Sumatera Utara,26,2,4,6,9,8,20,0,29/Nov/2017 08:59:35
7171104,RS Mata Provinsi Sulawesi Utara,12,2,2,4,5,3,8,0,01/Mar/2018 04:52:10
1376017,RS Ibu dan Anak Annisa Payakumbuh,33,0,22,22,0,11,11,0,03/Apr/2020 08:15:45
3525101,RS Umar Masud,132,11,29,40,29,64,92,0,01/Apr/2020 01:03:30
1674003,RS Siloam Silampari,43,6,10,16,15,12,27,0,14/Apr/2020 06:11:43
5318002,RS Daerah Aeramo Kabupaten Nagekeo,46,4,10,14,10,27,32,0,11/Feb/2019 05:49:19
3403025,RS Bethesda Wonosari,13,1,2,3,5,2,10,0,13/Apr/2020 06:56:36
7305013,RS Maryam Citra Medika,6,0,0,0,0,0,6,0,18/Apr/2020 08:36:20
5316003,RS Umum Daerah Waibakul,105,16,34,50,16,39,55,0,01/Mar/2018 12:29:32
1174023,RS Ibu dan Anak ABBY,43,2,17,19,5,19,24,0,26/Feb/2019 06:00:03
7373008,RS Dokter Palemmai Tandi,105,0,0,0,0,0,105,0,27/Feb/2018 12:12:37
1311002,RS Umum Daerah Sungai Rumbai,17,1,1,2,8,7,15,0,01/Apr/2020 07:05:43
7173002,RS Umum Daerah Anugerah,72,7,5,12,25,35,60,0,16/Apr/2020 07:58:06
3302232,RS Hermina Purwokerto,114,20,37,57,24,34,57,0,16/Apr/2020 01:02:32
6202025,RS Kelas D Pratama Parenggean,44,0,3,3,20,21,41,0,18/Apr/2020 02:56:17
1309023,RS Islam Ibnu Sina Panti Yarsi,37,8,23,31,0,0,6,0,07/Feb/2019 14:51:36
3573260,RSIA REFA HUSADA,1,0,0,0,0,0,1,0,16/Apr/2020 11:10:08
3527013,RS Nindhita,3,0,1,1,1,1,2,0,11/Jan/2019 05:56:31
9231002,RSUD Lukas Enembe Kabupaten Memberamo Tengah,33,9,13,22,12,21,11,0,02/Jul/2018 10:54:10
1471398,RS Daerah Madani Kota Pekanbaru,38,0,0,0,0,0,38,0,18/Apr/2020 08:25:31
3603191,RS Umum Daerah Pakuhaji,8,0,0,0,4,4,8,0,16/Apr/2020 04:33:57
1571169,RS Umum Daerah H. Abdurrahman Sayoeti,22,0,0,0,0,2,22,0,17/Apr/2020 03:33:37
1275930,RSU HERMINA MEDAN,63,9,12,21,17,24,42,0,13/Apr/2020 07:19:43
3306111,RS Amanah Umat Purworejo,63,5,8,13,24,23,50,0,17/Apr/2020 06:27:11
5271103,RS Mata Nusa Tenggara Barat,14,0,0,0,7,7,14,0,19/Apr/2020 01:25:45
7318056,RS Sinar Kasih,73,10,7,17,35,42,56,0,18/Apr/2020 03:07:24
6472130,RS Hermina Samarinda,19,3,12,15,2,1,4,0,17/Apr/2020 18:08:20
1871448,RS Mata Lampung Eye Center (LEC),10,0,0,0,5,5,10,0,26/Feb/2019 11:16:31
6111002,RS Umum Daerah Sultan Muhammad Jamaludin I,0,0,0,0,0,0,0,0,20/Feb/2019 12:05:20
1703046,RSUD Lagita,70,1,8,9,18,44,61,0,07/Apr/2020 03:15:05
3301112,RSU Raffa Majenang,13,0,0,0,6,7,13,0,16/Jan/2019 05:33:37
3273546,RS Ibu dan Anak Al Islam,0,0,0,0,0,0,0,0,16/Apr/2020 11:39:50
7604027,RS Bhayangkara Tkt. IV Polda Sulbar,29,5,2,7,9,13,22,0,17/Apr/2020 08:29:09
3603192,RS Mitra Keluarga Gading Serpong,78,13,22,35,0,0,43,0,16/Apr/2020 09:04:18
5272005,RSUD Kota Bima,45,1,8,9,6,6,36,0,19/Apr/2020 01:53:53
1806039,RS Medika Insani,24,8,8,16,18,18,8,6,09/Apr/2020 07:08:24
6308014,RS Mulia Amuntai,41,0,1,1,0,0,40,0,20/Nov/2018 06:52:16
1273108,RS Rasyida Siantar,7,0,0,0,4,3,7,0,05/Mar/2019 10:45:48
3512039,RS Ibu dan Anak Jatimed,0,0,0,0,0,0,0,0,05/Mar/2019 09:56:28
3172771,RSUD CIPAYUNG,40,6,0,6,34,0,34,0,16/Apr/2020 10:19:21
1111005,RSU Prima Inti Medika,4,0,0,0,4,4,4,0,28/Mar/2020 05:50:07
1503039,RS Langit Golden Medika,3,0,0,0,3,3,3,0,16/Apr/2020 09:01:46
3506066,RS Umum Daerah Simpang Lima Gumul Kediri,122,10,7,17,46,59,105,0,17/Apr/2020 06:42:28
9271079,RS Provita Jayapura,0,0,0,0,0,0,0,0,17/Apr/2020 23:20:36
3310416,RSU PKU Muhammadiyah Delanggu,214,41,61,102,0,0,112,0,14/Apr/2020 14:18:40
7206014,RS Umum Hj. Zubaeda Bantilan,38,9,3,12,16,10,26,0,08/Mar/2019 05:02:11
1813001,RSUD KH. Muhammad Thohir KRUI,0,1,1,2,8,9,-2,0,19/Apr/2020 02:03:29
9213038,RS Bergerak Kab.Boven Digoel,22,12,10,22,12,10,0,0,07/Mar/2019 06:54:21
1371466,RSU Hermina Padang,49,7,10,17,13,19,32,0,18/Apr/2020 04:02:44
3603193,RS Siloam Hospitals Kelapa Dua,150,30,26,56,45,49,94,0,17/Apr/2020 04:27:36
3216446,RSIA Aisyah Qurrataain,19,0,1,1,4,14,18,0,21/Dec/2018 02:39:56
7203018,RS Umum Pratama Paku,10,1,0,1,1,0,9,0,09/Apr/2020 03:07:16
3573263,RS Khusus Kanker Onkologi Sentani,17,0,0,0,0,0,17,0,14/Apr/2020 10:05:24
6401018,RS Pratama Batu Engau,13,2,3,5,8,5,8,0,31/Mar/2020 01:52:05
3201256,RS Universitas Indonesia,0,9,6,15,0,0,-15,0,14/Apr/2020 11:50:19
1607014,RS Hermina OPI Jakabaring,54,6,8,14,0,0,40,0,15/Apr/2020 01:01:10
1407016,RS Ibu dan Anak Harapan Medika,4,0,0,0,0,4,4,0,21/Mar/2020 10:29:30
3308021,RS Umum Syubbanul Wathon,40,0,0,0,0,0,40,0,12/Jan/2019 07:07:04
7315018,RSUD Madising,50,4,5,9,16,25,41,0,23/Feb/2019 05:57:50
5205016,RS Pratama Manggelewa,50,3,3,6,24,20,44,0,06/Apr/2020 01:52:19
1224002,RS Pratama Kabupaten Nias Utara,50,4,2,6,21,23,44,0,17/Apr/2020 04:33:07
1671350,RS Umum Daerah Gandus Palembang,32,0,0,0,13,19,32,0,19/Apr/2020 02:24:01
5108080,RS Balimed Buleleng,0,18,26,44,0,0,-44,0,01/Apr/2020 02:37:22
1271033,RS Metta Medika II,14,0,1,1,0,0,13,0,14/Apr/2020 04:39:07
3216448,RS Mitra Keluarga Pratama,46,5,7,12,17,17,34,0,16/Apr/2020 05:26:37
3328081,RS Harapan Sehat Slawi,103,0,0,0,0,0,103,0,17/Apr/2020 11:20:16
3329112,RS Harapan Sehat Jatibarang,98,1,3,4,46,52,94,0,15/Apr/2020 10:50:09
3275065,RS Awal Bros Bekasi Utara,36,5,10,15,6,6,21,0,12/Apr/2020 08:46:12
3216449,RS Ananda Babelan,142,0,3,3,71,68,139,0,18/Apr/2020 06:29:46
3372240,RSU Umum Daerah Bung Karno Kota Surakarta,57,0,0,0,30,27,57,0,07/Apr/2020 06:10:10
7322004,RS Hikmah Sejahtera Sukamaju,69,13,13,26,35,37,43,0,15/Apr/2020 12:53:45
3324040,RSU Charlie Hospital,0,0,0,0,0,0,0,0,16/Apr/2020 14:51:02
1471399,RS Hermina Pekanbaru,57,2,1,3,15,18,54,0,13/Apr/2020 08:03:56
3216450,RS Eka Bekasi,3,0,0,0,0,0,3,0,16/Apr/2020 12:33:32
3671224,RS Sari Asih Cipondoh,0,0,0,0,0,0,0,0,18/Apr/2020 09:16:51
3372201,RSU Surakarta BKPM,16,0,0,0,0,0,16,0,16/Apr/2020 15:24:12
3201259,RS Pena 98,2,0,0,0,0,0,2,0,16/Apr/2020 16:14:00
1507013,RS Umum Daerah Suryah Khairuddin,1,1,0,1,0,0,0,0,17/Apr/2020 10:37:35
3311231,RS Islam Surakarta YARSIS,109,9,0,9,100,0,100,0,11/Apr/2020 13:35:03
3215146,RS Khusus Paru Kabupaten Karawang,44,12,14,26,0,0,18,0,18/Apr/2020 10:25:19
